cluster,size,seq,series,begin,end,id,book,author,ch_len
249108214663,2,43,Shamela0006667-ara1.mARkdown,1038,1623,Shamela0006667,0845Maqrizi.Suluk,0845Maqrizi,585
42949738876,2,714,Shamela0006667-ara1.mARkdown,1,374,Shamela0006667,0845Maqrizi.Suluk,0845Maqrizi,373
120259168390,3,1308,Shamela0006667-ara1.mARkdown,1159,1466,Shamela0006667,0845Maqrizi.Suluk,0845Maqrizi,307
455266616364,2,804,Shamela0006667-ara1.mARkdown,325,1022,Shamela0006667,0845Maqrizi.Suluk,0845Maqrizi,697
386547158982,2,229,Shamela0006667-ara1.mARkdown,90,1392,Shamela0006667,0845Maqrizi.Suluk,0845Maqrizi,1302
317827615952,2,175,Shamela0006667-ara1.mARkdown,498,1406,Shamela0006667,0845Maqrizi.Suluk,0845Maqrizi,908
231928352713,2,137,Shamela0006667-ara1.mARkdown,303,1676,Shamela0006667,0845Maqrizi.Suluk,0845Maqrizi,1373
94489424319,2,801,Shamela0006667-ara1.mARkdown,6,474,Shamela0006667,0845Maqrizi.Suluk,0845Maqrizi,468
120259168390,3,1312,Shamela0006667-ara1.mARkdown,1008,1387,Shamela0006667,0845Maqrizi.Suluk,0845Maqrizi,379
420906863308,2,219,Shamela0006667-ara1.mARkdown,1436,1624,Shamela0006667,0845Maqrizi.Suluk,0845Maqrizi,188
120259145256,2,219,Shamela0006667-ara1.mARkdown,491,1436,Shamela0006667,0845Maqrizi.Suluk,0845Maqrizi,945
523986100685,2,66,Shamela0006667-ara1.mARkdown,346,604,Shamela0006667,0845Maqrizi.Suluk,0845Maqrizi,258
60129580395,2,2052,Shamela0006667-ara1.mARkdown,1286,1612,Shamela0006667,0845Maqrizi.Suluk,0845Maqrizi,326
223338432694,2,1031,Shamela0006667-ara1.mARkdown,1,766,Shamela0006667,0845Maqrizi.Suluk,0845Maqrizi,765
137439005463,2,230,Shamela0006667-ara1.mARkdown,1,776,Shamela0006667,0845Maqrizi.Suluk,0845Maqrizi,775
360777414885,2,49,Shamela0006667-ara1.mARkdown,460,622,Shamela0006667,0845Maqrizi.Suluk,0845Maqrizi,162
8590007563,2,239,Shamela0006667-ara1.mARkdown,514,1293,Shamela0006667,0845Maqrizi.Suluk,0845Maqrizi,779
25769809147,2,123,Shamela0006667-ara1.mARkdown,1137,1616,Shamela0006667,0845Maqrizi.Suluk,0845Maqrizi,479
68719633569,2,133,Shamela0006667-ara1.mARkdown,709,1386,Shamela0006667,0845Maqrizi.Suluk,0845Maqrizi,677
128849124623,2,133,Shamela0006667-ara1.mARkdown,488,1045,Shamela0006667,0845Maqrizi.Suluk,0845Maqrizi,557
163208878138,2,158,Shamela0006667-ara1.mARkdown,288,930,Shamela0006667,0845Maqrizi.Suluk,0845Maqrizi,642
42949800424,3,722,Shamela0006667-ara1.mARkdown,1193,1509,Shamela0006667,0845Maqrizi.Suluk,0845Maqrizi,316
309237808413,3,1360,Shamela0006667-ara1.mARkdown,170,428,Shamela0006667,0845Maqrizi.Suluk,0845Maqrizi,258
94489340787,2,129,Shamela0006667-ara1.mARkdown,1418,1642,Shamela0006667,0845Maqrizi.Suluk,0845Maqrizi,224
180388837833,2,672,Shamela0006667-ara1.mARkdown,1027,1622,Shamela0006667,0845Maqrizi.Suluk,0845Maqrizi,595
128849059856,2,171,Shamela0006667-ara1.mARkdown,264,762,Shamela0006667,0845Maqrizi.Suluk,0845Maqrizi,498
198404,2,632,Shamela0006667-ara1.mARkdown,1056,1489,Shamela0006667,0845Maqrizi.Suluk,0845Maqrizi,433
42949727200,3,608,Shamela0006667-ara1.mARkdown,1150,1386,Shamela0006667,0845Maqrizi.Suluk,0845Maqrizi,236
94489340788,3,150,Shamela0006667-ara1.mARkdown,1,230,Shamela0006667,0845Maqrizi.Suluk,0845Maqrizi,229
386547245886,2,30,Shamela0006667-ara1.mARkdown,864,1080,Shamela0006667,0845Maqrizi.Suluk,0845Maqrizi,216
429496734083,2,1293,Shamela0006667-ara1.mARkdown,1,578,Shamela0006667,0845Maqrizi.Suluk,0845Maqrizi,577
25769934857,2,240,Shamela0006667-ara1.mARkdown,861,1233,Shamela0006667,0845Maqrizi.Suluk,0845Maqrizi,372
481036428048,2,228,Shamela0006667-ara1.mARkdown,1062,1557,Shamela0006667,0845Maqrizi.Suluk,0845Maqrizi,495
231928380912,2,292,Shamela0006667-ara1.mARkdown,1,191,Shamela0006667,0845Maqrizi.Suluk,0845Maqrizi,190
231928380913,2,292,Shamela0006667-ara1.mARkdown,767,1306,Shamela0006667,0845Maqrizi.Suluk,0845Maqrizi,539
257698038588,2,242,Shamela0006667-ara1.mARkdown,1018,1605,Shamela0006667,0845Maqrizi.Suluk,0845Maqrizi,587
8590007565,2,237,Shamela0006667-ara1.mARkdown,696,1160,Shamela0006667,0845Maqrizi.Suluk,0845Maqrizi,464
128849161371,2,227,Shamela0006667-ara1.mARkdown,95,763,Shamela0006667,0845Maqrizi.Suluk,0845Maqrizi,668
128849161370,2,227,Shamela0006667-ara1.mARkdown,1228,1457,Shamela0006667,0845Maqrizi.Suluk,0845Maqrizi,229
25769923286,2,751,Shamela0006667-ara1.mARkdown,927,1461,Shamela0006667,0845Maqrizi.Suluk,0845Maqrizi,534
429496868666,2,751,Shamela0006667-ara1.mARkdown,123,768,Shamela0006667,0845Maqrizi.Suluk,0845Maqrizi,645
395137004699,2,803,Shamela0006667-ara1.mARkdown,825,1689,Shamela0006667,0845Maqrizi.Suluk,0845Maqrizi,864
60129737749,2,1836,Shamela0006667-ara1.mARkdown,965,1409,Shamela0006667,0845Maqrizi.Suluk,0845Maqrizi,444
103079318985,2,359,Shamela0006667-ara1.mARkdown,1393,1633,Shamela0006667,0845Maqrizi.Suluk,0845Maqrizi,240
8590002728,2,802,Shamela0006667-ara1.mARkdown,221,1015,Shamela0006667,0845Maqrizi.Suluk,0845Maqrizi,794
352187339836,2,198,Shamela0006667-ara1.mARkdown,1436,1612,Shamela0006667,0845Maqrizi.Suluk,0845Maqrizi,176
283467945064,2,220,Shamela0006667-ara1.mARkdown,1,1516,Shamela0006667,0845Maqrizi.Suluk,0845Maqrizi,1515
8590080988,2,143,Shamela0006667-ara1.mARkdown,756,1558,Shamela0006667,0845Maqrizi.Suluk,0845Maqrizi,802
128849034762,2,143,Shamela0006667-ara1.mARkdown,45,484,Shamela0006667,0845Maqrizi.Suluk,0845Maqrizi,439
420906871030,2,1257,Shamela0006667-ara1.mARkdown,161,775,Shamela0006667,0845Maqrizi.Suluk,0845Maqrizi,614
446676755153,2,1257,Shamela0006667-ara1.mARkdown,1408,1552,Shamela0006667,0845Maqrizi.Suluk,0845Maqrizi,144
103079311595,2,1214,Shamela0006667-ara1.mARkdown,1088,1358,Shamela0006667,0845Maqrizi.Suluk,0845Maqrizi,270
138781,2,2355,Shamela0006667-ara1.mARkdown,909,1302,Shamela0006667,0845Maqrizi.Suluk,0845Maqrizi,393
292057948163,2,329,Shamela0006667-ara1.mARkdown,21,616,Shamela0006667,0845Maqrizi.Suluk,0845Maqrizi,595
386547174840,2,494,Shamela0006667-ara1.mARkdown,1137,1628,Shamela0006667,0845Maqrizi.Suluk,0845Maqrizi,491
60129579692,2,2296,Shamela0006667-ara1.mARkdown,5,254,Shamela0006667,0845Maqrizi.Suluk,0845Maqrizi,249
154618837563,2,31,Shamela0006667-ara1.mARkdown,609,1041,Shamela0006667,0845Maqrizi.Suluk,0845Maqrizi,432
214748514992,3,31,Shamela0006667-ara1.mARkdown,1246,1466,Shamela0006667,0845Maqrizi.Suluk,0845Maqrizi,220
386547065392,2,176,Shamela0006667-ara1.mARkdown,1221,1664,Shamela0006667,0845Maqrizi.Suluk,0845Maqrizi,443
317827615953,2,176,Shamela0006667-ara1.mARkdown,524,1214,Shamela0006667,0845Maqrizi.Suluk,0845Maqrizi,690
386547259004,2,91,Shamela0006667-ara1.mARkdown,629,1176,Shamela0006667,0845Maqrizi.Suluk,0845Maqrizi,547
60129646049,2,134,Shamela0006667-ara1.mARkdown,5,488,Shamela0006667,0845Maqrizi.Suluk,0845Maqrizi,483
8590007566,2,238,Shamela0006667-ara1.mARkdown,1051,1490,Shamela0006667,0845Maqrizi.Suluk,0845Maqrizi,439
77309431148,2,310,Shamela0006667-ara1.mARkdown,164,420,Shamela0006667,0845Maqrizi.Suluk,0845Maqrizi,256
335007487069,2,427,Shamela0006667-ara1.mARkdown,13,875,Shamela0006667,0845Maqrizi.Suluk,0845Maqrizi,862
257698041770,2,93,Shamela0006667-ara1.mARkdown,1544,1673,Shamela0006667,0845Maqrizi.Suluk,0845Maqrizi,129
292057859157,2,93,Shamela0006667-ara1.mARkdown,292,468,Shamela0006667,0845Maqrizi.Suluk,0845Maqrizi,176
386547242171,2,1078,Shamela0006667-ara1.mARkdown,305,655,Shamela0006667,0845Maqrizi.Suluk,0845Maqrizi,350
231928379074,2,1611,Shamela0006667-ara1.mARkdown,281,872,Shamela0006667,0845Maqrizi.Suluk,0845Maqrizi,591
103079273390,2,1157,Shamela0006667-ara1.mARkdown,452,1262,Shamela0006667,0845Maqrizi.Suluk,0845Maqrizi,810
68719633570,2,132,Shamela0006667-ara1.mARkdown,1269,1486,Shamela0006667,0845Maqrizi.Suluk,0845Maqrizi,217
558345784425,2,132,Shamela0006667-ara1.mARkdown,97,1646,Shamela0006667,0845Maqrizi.Suluk,0845Maqrizi,1549
463856582286,2,1266,Shamela0006667-ara1.mARkdown,757,1145,Shamela0006667,0845Maqrizi.Suluk,0845Maqrizi,388
204160,3,294,Shamela0006667-ara1.mARkdown,534,1674,Shamela0006667,0845Maqrizi.Suluk,0845Maqrizi,1140
472446500905,2,287,Shamela0006667-ara1.mARkdown,55,1165,Shamela0006667,0845Maqrizi.Suluk,0845Maqrizi,1110
34359784669,2,115,Shamela0006667-ara1.mARkdown,1223,1423,Shamela0006667,0845Maqrizi.Suluk,0845Maqrizi,200
130465,2,124,Shamela0006667-ara1.mARkdown,85,1263,Shamela0006667,0845Maqrizi.Suluk,0845Maqrizi,1178
274877952890,2,221,Shamela0006667-ara1.mARkdown,630,1471,Shamela0006667,0845Maqrizi.Suluk,0845Maqrizi,841
68719596653,2,2200,Shamela0006667-ara1.mARkdown,646,1621,Shamela0006667,0845Maqrizi.Suluk,0845Maqrizi,975
197568687204,2,73,Shamela0006667-ara1.mARkdown,928,1355,Shamela0006667,0845Maqrizi.Suluk,0845Maqrizi,427
197568687205,2,73,Shamela0006667-ara1.mARkdown,666,947,Shamela0006667,0845Maqrizi.Suluk,0845Maqrizi,281
137439162934,2,750,Shamela0006667-ara1.mARkdown,333,1385,Shamela0006667,0845Maqrizi.Suluk,0845Maqrizi,1052
111669197346,2,2251,Shamela0006667-ara1.mARkdown,673,864,Shamela0006667,0845Maqrizi.Suluk,0845Maqrizi,191
223338349612,2,138,Shamela0006667-ara1.mARkdown,834,1116,Shamela0006667,0845Maqrizi.Suluk,0845Maqrizi,282
420906957293,2,138,Shamela0006667-ara1.mARkdown,1,619,Shamela0006667,0845Maqrizi.Suluk,0845Maqrizi,618
429496843914,2,1134,Shamela0006667-ara1.mARkdown,570,1126,Shamela0006667,0845Maqrizi.Suluk,0845Maqrizi,556
51539784572,2,508,Shamela0006667-ara1.mARkdown,1199,1535,Shamela0006667,0845Maqrizi.Suluk,0845Maqrizi,336
17179921461,2,222,Shamela0006667-ara1.mARkdown,615,1074,Shamela0006667,0845Maqrizi.Suluk,0845Maqrizi,459
163208766903,2,90,Shamela0006667-ara1.mARkdown,335,488,Shamela0006667,0845Maqrizi.Suluk,0845Maqrizi,153
523986177467,2,2201,Shamela0006667-ara1.mARkdown,1,292,Shamela0006667,0845Maqrizi.Suluk,0845Maqrizi,291
386547235188,3,3390,Shia003616Vols-ara1,1,214,Shia003616Vols,0845Maqrizi.ImtacAsmac,0845Maqrizi,213
652835085542,2,3390,Shia003616Vols-ara1,1060,1525,Shia003616Vols,0845Maqrizi.ImtacAsmac,0845Maqrizi,465
652835085543,2,3390,Shia003616Vols-ara1,774,1060,Shia003616Vols,0845Maqrizi.ImtacAsmac,0845Maqrizi,286
309237713133,3,3389,Shia003616Vols-ara1,1260,1582,Shia003616Vols,0845Maqrizi.ImtacAsmac,0845Maqrizi,322
174022,2,3247,Shia003616Vols-ara1,1,1123,Shia003616Vols,0845Maqrizi.ImtacAsmac,0845Maqrizi,1122
51539763992,2,229,Shamela0000176-ara1.completed,731,1275,Shamela0000176,0845Maqrizi.ItticazHunafa,0845Maqrizi,544
128849211964,2,485,Shamela0000176-ara1.completed,1003,1366,Shamela0000176,0845Maqrizi.ItticazHunafa,0845Maqrizi,363
60129608771,2,496,Shamela0000176-ara1.completed,246,1296,Shamela0000176,0845Maqrizi.ItticazHunafa,0845Maqrizi,1050
60129608772,3,496,Shamela0000176-ara1.completed,315,930,Shamela0000176,0845Maqrizi.ItticazHunafa,0845Maqrizi,615
60129544728,3,496,Shamela0000176-ara1.completed,930,1185,Shamela0000176,0845Maqrizi.ItticazHunafa,0845Maqrizi,255
25769994874,2,361,Shamela0000176-ara1.completed,289,749,Shamela0000176,0845Maqrizi.ItticazHunafa,0845Maqrizi,460
25769994872,2,361,Shamela0000176-ara1.completed,289,1321,Shamela0000176,0845Maqrizi.ItticazHunafa,0845Maqrizi,1032
317827624824,2,55,Shamela0000176-ara1.completed,1276,1516,Shamela0000176,0845Maqrizi.ItticazHunafa,0845Maqrizi,240
412316951495,2,55,Shamela0000176-ara1.completed,1,1276,Shamela0000176,0845Maqrizi.ItticazHunafa,0845Maqrizi,1275
498216261314,2,495,Shamela0000176-ara1.completed,277,1224,Shamela0000176,0845Maqrizi.ItticazHunafa,0845Maqrizi,947
300647877794,2,464,Shamela0000176-ara1.completed,758,1018,Shamela0000176,0845Maqrizi.ItticazHunafa,0845Maqrizi,260
171798825724,2,23,Shamela0000176-ara1.completed,1123,1668,Shamela0000176,0845Maqrizi.ItticazHunafa,0845Maqrizi,545
240518250795,2,405,Shamela0000176-ara1.completed,422,655,Shamela0000176,0845Maqrizi.ItticazHunafa,0845Maqrizi,233
369367367149,2,530,Shamela0000176-ara1.completed,582,749,Shamela0000176,0845Maqrizi.ItticazHunafa,0845Maqrizi,167
171798823746,2,381,Shamela0000176-ara1.completed,1401,1633,Shamela0000176,0845Maqrizi.ItticazHunafa,0845Maqrizi,232
34359841043,2,381,Shamela0000176-ara1.completed,206,501,Shamela0000176,0845Maqrizi.ItticazHunafa,0845Maqrizi,295
420906952217,2,590,Shamela0000176-ara1.completed,703,1477,Shamela0000176,0845Maqrizi.ItticazHunafa,0845Maqrizi,774
240518300705,2,380,Shamela0000176-ara1.completed,11,1194,Shamela0000176,0845Maqrizi.ItticazHunafa,0845Maqrizi,1183
240518300704,2,380,Shamela0000176-ara1.completed,987,1608,Shamela0000176,0845Maqrizi.ItticazHunafa,0845Maqrizi,621
85899397428,2,56,Shamela0000176-ara1.completed,1293,1598,Shamela0000176,0845Maqrizi.ItticazHunafa,0845Maqrizi,305
85899397426,2,56,Shamela0000176-ara1.completed,17,468,Shamela0000176,0845Maqrizi.ItticazHunafa,0845Maqrizi,451
94489370755,3,446,Shamela0000176-ara1.completed,1,1096,Shamela0000176,0845Maqrizi.ItticazHunafa,0845Maqrizi,1095
506806278803,2,446,Shamela0000176-ara1.completed,51,1405,Shamela0000176,0845Maqrizi.ItticazHunafa,0845Maqrizi,1354
174005,3,446,Shamela0000176-ara1.completed,1096,1451,Shamela0000176,0845Maqrizi.ItticazHunafa,0845Maqrizi,355
506806246041,2,218,Shamela0000176-ara1.completed,389,895,Shamela0000176,0845Maqrizi.ItticazHunafa,0845Maqrizi,506
395137069165,2,37,Shamela0000176-ara1.completed,116,1129,Shamela0000176,0845Maqrizi.ItticazHunafa,0845Maqrizi,1013
240518331527,2,430,Shamela0000176-ara1.completed,818,1042,Shamela0000176,0845Maqrizi.ItticazHunafa,0845Maqrizi,224
146028906628,2,430,Shamela0000176-ara1.completed,1240,1635,Shamela0000176,0845Maqrizi.ItticazHunafa,0845Maqrizi,395
34359844472,2,155,Shamela0000176-ara1.completed,570,994,Shamela0000176,0845Maqrizi.ItticazHunafa,0845Maqrizi,424
34359844473,2,155,Shamela0000176-ara1.completed,994,1259,Shamela0000176,0845Maqrizi.ItticazHunafa,0845Maqrizi,265
34359844471,2,155,Shamela0000176-ara1.completed,11,929,Shamela0000176,0845Maqrizi.ItticazHunafa,0845Maqrizi,918
60129675305,2,412,Shamela0000176-ara1.completed,1,311,Shamela0000176,0845Maqrizi.ItticazHunafa,0845Maqrizi,310
51539767846,2,412,Shamela0000176-ara1.completed,311,1539,Shamela0000176,0845Maqrizi.ItticazHunafa,0845Maqrizi,1228
128849078875,2,215,Shamela0000176-ara1.completed,1001,1295,Shamela0000176,0845Maqrizi.ItticazHunafa,0845Maqrizi,294
326417667294,2,375,Shamela0000176-ara1.completed,936,1309,Shamela0000176,0845Maqrizi.ItticazHunafa,0845Maqrizi,373
103079384420,2,408,Shamela0000176-ara1.completed,1257,1514,Shamela0000176,0845Maqrizi.ItticazHunafa,0845Maqrizi,257
266288029622,2,424,Shamela0000176-ara1.completed,1196,1542,Shamela0000176,0845Maqrizi.ItticazHunafa,0845Maqrizi,346
214748433105,2,237,Shamela0000176-ara1.completed,1070,1333,Shamela0000176,0845Maqrizi.ItticazHunafa,0845Maqrizi,263
214748433106,2,237,Shamela0000176-ara1.completed,106,253,Shamela0000176,0845Maqrizi.ItticazHunafa,0845Maqrizi,147
429496740612,2,378,Shamela0000176-ara1.completed,287,1181,Shamela0000176,0845Maqrizi.ItticazHunafa,0845Maqrizi,894
163208922541,2,373,Shamela0000176-ara1.completed,917,1593,Shamela0000176,0845Maqrizi.ItticazHunafa,0845Maqrizi,676
283468021389,2,373,Shamela0000176-ara1.completed,410,1269,Shamela0000176,0845Maqrizi.ItticazHunafa,0845Maqrizi,859
128849144191,2,183,Shamela0000176-ara1.completed,1248,1617,Shamela0000176,0845Maqrizi.ItticazHunafa,0845Maqrizi,369
103079217153,2,12,Shamela0000176-ara1.completed,1047,1365,Shamela0000176,0845Maqrizi.ItticazHunafa,0845Maqrizi,318
103079217154,2,12,Shamela0000176-ara1.completed,37,331,Shamela0000176,0845Maqrizi.ItticazHunafa,0845Maqrizi,294
8590082492,2,604,Shamela0000176-ara1.completed,630,1524,Shamela0000176,0845Maqrizi.ItticazHunafa,0845Maqrizi,894
154314,2,604,Shamela0000176-ara1.completed,630,1240,Shamela0000176,0845Maqrizi.ItticazHunafa,0845Maqrizi,610
137439112417,2,452,Shamela0000176-ara1.completed,1015,1444,Shamela0000176,0845Maqrizi.ItticazHunafa,0845Maqrizi,429
292057950548,2,556,Shamela0000176-ara1.completed,525,1234,Shamela0000176,0845Maqrizi.ItticazHunafa,0845Maqrizi,709
369367226786,2,217,Shamela0000176-ara1.completed,469,1543,Shamela0000176,0845Maqrizi.ItticazHunafa,0845Maqrizi,1074
128849078874,2,217,Shamela0000176-ara1.completed,910,1420,Shamela0000176,0845Maqrizi.ItticazHunafa,0845Maqrizi,510
360777427966,3,498,Shamela0000176-ara1.completed,1,311,Shamela0000176,0845Maqrizi.ItticazHunafa,0845Maqrizi,310
360777427964,2,498,Shamela0000176-ara1.completed,350,1200,Shamela0000176,0845Maqrizi.ItticazHunafa,0845Maqrizi,850
498216216595,2,372,Shamela0000176-ara1.completed,1,279,Shamela0000176,0845Maqrizi.ItticazHunafa,0845Maqrizi,278
377957299859,2,372,Shamela0000176-ara1.completed,284,557,Shamela0000176,0845Maqrizi.ItticazHunafa,0845Maqrizi,273
317827621293,2,39,Shamela0000176-ara1.completed,407,892,Shamela0000176,0845Maqrizi.ItticazHunafa,0845Maqrizi,485
34359891301,2,52,Shamela0000176-ara1.completed,727,1606,Shamela0000176,0845Maqrizi.ItticazHunafa,0845Maqrizi,879
25770019845,2,557,Shamela0000176-ara1.completed,246,543,Shamela0000176,0845Maqrizi.ItticazHunafa,0845Maqrizi,297
206158616680,2,77,Shamela0000176-ara1.completed,1215,1481,Shamela0000176,0845Maqrizi.ItticazHunafa,0845Maqrizi,266
137439112418,2,451,Shamela0000176-ara1.completed,1378,1511,Shamela0000176,0845Maqrizi.ItticazHunafa,0845Maqrizi,133
541166012669,3,78,Shamela0000176-ara1.completed,444,1141,Shamela0000176,0845Maqrizi.ItticazHunafa,0845Maqrizi,697
197568661899,2,78,Shamela0000176-ara1.completed,77,232,Shamela0000176,0845Maqrizi.ItticazHunafa,0845Maqrizi,155
34359826412,2,219,Shamela0000176-ara1.completed,1494,1738,Shamela0000176,0845Maqrizi.ItticazHunafa,0845Maqrizi,244
34359826413,2,219,Shamela0000176-ara1.completed,736,1667,Shamela0000176,0845Maqrizi.ItticazHunafa,0845Maqrizi,931
34359826411,2,219,Shamela0000176-ara1.completed,1,727,Shamela0000176,0845Maqrizi.ItticazHunafa,0845Maqrizi,726
77309441068,2,535,Shamela0000176-ara1.completed,320,550,Shamela0000176,0845Maqrizi.ItticazHunafa,0845Maqrizi,230
154618938985,3,471,Shamela0000176-ara1.completed,341,1038,Shamela0000176,0845Maqrizi.ItticazHunafa,0845Maqrizi,697
283468021390,2,379,Shamela0000176-ara1.completed,1242,1526,Shamela0000176,0845Maqrizi.ItticazHunafa,0845Maqrizi,284
377957326963,2,379,Shamela0000176-ara1.completed,1,1009,Shamela0000176,0845Maqrizi.ItticazHunafa,0845Maqrizi,1008
51539763993,2,232,Shamela0000176-ara1.completed,1126,1463,Shamela0000176,0845Maqrizi.ItticazHunafa,0845Maqrizi,337
420906810096,2,608,Shamela0000176-ara1.completed,38,865,Shamela0000176,0845Maqrizi.ItticazHunafa,0845Maqrizi,827
429496874421,2,574,Shamela0000176-ara1.completed,501,697,Shamela0000176,0845Maqrizi.ItticazHunafa,0845Maqrizi,196
51539675146,2,75,Shamela0000176-ara1.completed,203,469,Shamela0000176,0845Maqrizi.ItticazHunafa,0845Maqrizi,266
128849230309,2,172,Shamela0000176-ara1.completed,166,728,Shamela0000176,0845Maqrizi.ItticazHunafa,0845Maqrizi,562
34359929872,5,331,Shamela0000176-ara1.completed,5,484,Shamela0000176,0845Maqrizi.ItticazHunafa,0845Maqrizi,479
77309544303,2,388,Shamela0000176-ara1.completed,1341,1635,Shamela0000176,0845Maqrizi.ItticazHunafa,0845Maqrizi,294
34359934594,3,489,Shamela0000176-ara1.completed,1173,1524,Shamela0000176,0845Maqrizi.ItticazHunafa,0845Maqrizi,351
429496766007,2,63,Shamela0000176-ara1.completed,1234,1651,Shamela0000176,0845Maqrizi.ItticazHunafa,0845Maqrizi,417
34359741052,3,203,Shamela0000176-ara1.completed,1231,1613,Shamela0000176,0845Maqrizi.ItticazHunafa,0845Maqrizi,382
395137137523,2,428,Shamela0000176-ara1.completed,573,860,Shamela0000176,0845Maqrizi.ItticazHunafa,0845Maqrizi,287
438086837649,2,564,Shamela0000176-ara1.completed,20,862,Shamela0000176,0845Maqrizi.ItticazHunafa,0845Maqrizi,842
309237683339,2,54,Shamela0000176-ara1.completed,1372,1609,Shamela0000176,0845Maqrizi.ItticazHunafa,0845Maqrizi,237
309237683338,2,54,Shamela0000176-ara1.completed,218,1372,Shamela0000176,0845Maqrizi.ItticazHunafa,0845Maqrizi,1154
77309587148,3,200,Shamela0000176-ara1.completed,654,993,Shamela0000176,0845Maqrizi.ItticazHunafa,0845Maqrizi,339
56702,2,68,Shamela0000176-ara1.completed,675,961,Shamela0000176,0845Maqrizi.ItticazHunafa,0845Maqrizi,286
128849142841,2,188,Shamela0000176-ara1.completed,1,417,Shamela0000176,0845Maqrizi.ItticazHunafa,0845Maqrizi,416
34359917827,2,371,Shamela0000176-ara1.completed,928,1469,Shamela0000176,0845Maqrizi.ItticazHunafa,0845Maqrizi,541
463856537424,2,422,Shamela0000176-ara1.completed,1311,1629,Shamela0000176,0845Maqrizi.ItticazHunafa,0845Maqrizi,318
283467899510,3,422,Shamela0000176-ara1.completed,151,570,Shamela0000176,0845Maqrizi.ItticazHunafa,0845Maqrizi,419
188978739682,2,192,Shamela0000176-ara1.completed,226,1287,Shamela0000176,0845Maqrizi.ItticazHunafa,0845Maqrizi,1061
51539761479,3,193,Shamela0000176-ara1.completed,551,986,Shamela0000176,0845Maqrizi.ItticazHunafa,0845Maqrizi,435
343597444921,2,193,Shamela0000176-ara1.completed,990,1575,Shamela0000176,0845Maqrizi.ItticazHunafa,0845Maqrizi,585
335007528182,3,444,Shamela0000176-ara1.completed,723,1626,Shamela0000176,0845Maqrizi.ItticazHunafa,0845Maqrizi,903
335007544772,2,154,Shamela0000176-ara1.completed,436,1470,Shamela0000176,0845Maqrizi.ItticazHunafa,0845Maqrizi,1034
8590082493,2,607,Shamela0000176-ara1.completed,865,1472,Shamela0000176,0845Maqrizi.ItticazHunafa,0845Maqrizi,607
292057967237,2,252,Shamela0000176-ara1.completed,412,970,Shamela0000176,0845Maqrizi.ItticazHunafa,0845Maqrizi,558
257698092709,2,610,Shamela0000176-ara1.completed,734,925,Shamela0000176,0845Maqrizi.ItticazHunafa,0845Maqrizi,191
128849195501,2,74,Shamela0000176-ara1.completed,629,1525,Shamela0000176,0845Maqrizi.ItticazHunafa,0845Maqrizi,896
309237862891,2,376,Shamela0000176-ara1.completed,1154,1679,Shamela0000176,0845Maqrizi.ItticazHunafa,0845Maqrizi,525
317827604236,2,29,Shamela0000176-ara1.completed,604,1026,Shamela0000176,0845Maqrizi.ItticazHunafa,0845Maqrizi,422
292057867987,2,450,Shamela0000176-ara1.completed,548,856,Shamela0000176,0845Maqrizi.ItticazHunafa,0845Maqrizi,308
292057867988,2,450,Shamela0000176-ara1.completed,1080,1273,Shamela0000176,0845Maqrizi.ItticazHunafa,0845Maqrizi,193
68719677906,2,382,Shamela0000176-ara1.completed,107,527,Shamela0000176,0845Maqrizi.ItticazHunafa,0845Maqrizi,420
128849169396,2,276,Shamela0000176-ara1.completed,816,1617,Shamela0000176,0845Maqrizi.ItticazHunafa,0845Maqrizi,801
94489388600,2,236,Shamela0000176-ara1.completed,297,838,Shamela0000176,0845Maqrizi.ItticazHunafa,0845Maqrizi,541
8590125492,2,453,Shamela0000176-ara1.completed,483,806,Shamela0000176,0845Maqrizi.ItticazHunafa,0845Maqrizi,323
8590125489,2,453,Shamela0000176-ara1.completed,48,470,Shamela0000176,0845Maqrizi.ItticazHunafa,0845Maqrizi,422
60129676221,2,244,Shamela0000176-ara1.completed,421,693,Shamela0000176,0845Maqrizi.ItticazHunafa,0845Maqrizi,272
7637,3,27,Shamela0000176-ara1.completed,316,614,Shamela0000176,0845Maqrizi.ItticazHunafa,0845Maqrizi,298
17180074830,2,606,Shamela0000176-ara1.completed,62,577,Shamela0000176,0845Maqrizi.ItticazHunafa,0845Maqrizi,515
17180074828,2,606,Shamela0000176-ara1.completed,646,1593,Shamela0000176,0845Maqrizi.ItticazHunafa,0845Maqrizi,947
188978775481,2,560,Shamela0000176-ara1.completed,414,608,Shamela0000176,0845Maqrizi.ItticazHunafa,0845Maqrizi,194
386547263731,2,377,Shamela0000176-ara1.completed,389,1268,Shamela0000176,0845Maqrizi.ItticazHunafa,0845Maqrizi,879
34359891302,2,53,Shamela0000176-ara1.completed,1,800,Shamela0000176,0845Maqrizi.ItticazHunafa,0845Maqrizi,799
206158464287,2,53,Shamela0000176-ara1.completed,800,1260,Shamela0000176,0845Maqrizi.ItticazHunafa,0845Maqrizi,460
283468034521,3,178,Shamela0000176-ara1.completed,1094,1419,Shamela0000176,0845Maqrizi.ItticazHunafa,0845Maqrizi,325
60129759957,3,449,Shamela0000176-ara1.completed,645,1446,Shamela0000176,0845Maqrizi.ItticazHunafa,0845Maqrizi,801
77309526181,2,449,Shamela0000176-ara1.completed,657,905,Shamela0000176,0845Maqrizi.ItticazHunafa,0845Maqrizi,248
60129759956,2,449,Shamela0000176-ara1.completed,880,1299,Shamela0000176,0845Maqrizi.ItticazHunafa,0845Maqrizi,419
197568661898,2,146,Shamela0000176-ara1.completed,616,861,Shamela0000176,0845Maqrizi.ItticazHunafa,0845Maqrizi,245
94489492728,2,463,Shamela0000176-ara1.completed,1048,1339,Shamela0000176,0845Maqrizi.ItticazHunafa,0845Maqrizi,291
369367271583,2,463,Shamela0000176-ara1.completed,761,1048,Shamela0000176,0845Maqrizi.ItticazHunafa,0845Maqrizi,287
85899441279,2,418,Shamela0000176-ara1.completed,955,1559,Shamela0000176,0845Maqrizi.ItticazHunafa,0845Maqrizi,604
111669178936,2,243,Shamela0000176-ara1.completed,1,580,Shamela0000176,0845Maqrizi.ItticazHunafa,0845Maqrizi,579
317827687164,2,149,Shamela0000176-ara1.completed,1266,1519,Shamela0000176,0845Maqrizi.ItticazHunafa,0845Maqrizi,253
274877972035,2,562,Shamela0000176-ara1.completed,1071,1605,Shamela0000176,0845Maqrizi.ItticazHunafa,0845Maqrizi,534
63827,3,493,Shamela0000176-ara1.completed,164,597,Shamela0000176,0845Maqrizi.ItticazHunafa,0845Maqrizi,433
63826,2,493,Shamela0000176-ara1.completed,538,1081,Shamela0000176,0845Maqrizi.ItticazHunafa,0845Maqrizi,543
180388654251,2,599,Shamela0000176-ara1.completed,187,420,Shamela0000176,0845Maqrizi.ItticazHunafa,0845Maqrizi,233
386547107668,3,226,Shamela0000176-ara1.completed,1315,1500,Shamela0000176,0845Maqrizi.ItticazHunafa,0845Maqrizi,185
8589978312,3,445,Shamela0000176-ara1.completed,1,1599,Shamela0000176,0845Maqrizi.ItticazHunafa,0845Maqrizi,1598
17179916313,3,33,Shamela0000176-ara1.completed,8,174,Shamela0000176,0845Maqrizi.ItticazHunafa,0845Maqrizi,166
34359739551,2,487,Shamela0000176-ara1.completed,323,981,Shamela0000176,0845Maqrizi.ItticazHunafa,0845Maqrizi,658
34359739553,2,487,Shamela0000176-ara1.completed,507,1066,Shamela0000176,0845Maqrizi.ItticazHunafa,0845Maqrizi,559
34359739554,2,487,Shamela0000176-ara1.completed,300,507,Shamela0000176,0845Maqrizi.ItticazHunafa,0845Maqrizi,207
240518250796,2,359,Shamela0000176-ara1.completed,889,1243,Shamela0000176,0845Maqrizi.ItticazHunafa,0845Maqrizi,354
111669251194,2,239,Shamela0000176-ara1.completed,950,1381,Shamela0000176,0845Maqrizi.ItticazHunafa,0845Maqrizi,431
137438966685,2,239,Shamela0000176-ara1.completed,359,580,Shamela0000176,0845Maqrizi.ItticazHunafa,0845Maqrizi,221
420907018140,2,384,Shamela0000176-ara1.completed,703,852,Shamela0000176,0845Maqrizi.ItticazHunafa,0845Maqrizi,149
103079323116,2,384,Shamela0000176-ara1.completed,1,703,Shamela0000176,0845Maqrizi.ItticazHunafa,0845Maqrizi,702
120259124154,3,83,Shamela0000176-ara1.completed,202,434,Shamela0000176,0845Maqrizi.ItticazHunafa,0845Maqrizi,232
120259124151,2,83,Shamela0000176-ara1.completed,202,965,Shamela0000176,0845Maqrizi.ItticazHunafa,0845Maqrizi,763
60129595691,3,195,Shamela0000176-ara1.completed,801,1045,Shamela0000176,0845Maqrizi.ItticazHunafa,0845Maqrizi,244
335007648479,2,152,Shamela0000176-ara1.completed,6,744,Shamela0000176,0845Maqrizi.ItticazHunafa,0845Maqrizi,738
326417621125,2,187,Shamela0000176-ara1.completed,251,641,Shamela0000176,0845Maqrizi.ItticazHunafa,0845Maqrizi,390
128849142840,2,187,Shamela0000176-ara1.completed,779,1635,Shamela0000176,0845Maqrizi.ItticazHunafa,0845Maqrizi,856
463856537423,2,423,Shamela0000176-ara1.completed,1,144,Shamela0000176,0845Maqrizi.ItticazHunafa,0845Maqrizi,143
283467940971,2,64,Shamela0000176-ara1.completed,293,1187,Shamela0000176,0845Maqrizi.ItticazHunafa,0845Maqrizi,894
283467940974,2,64,Shamela0000176-ara1.completed,4,293,Shamela0000176,0845Maqrizi.ItticazHunafa,0845Maqrizi,289
249108236404,2,220,Shamela0000176-ara1.completed,12,324,Shamela0000176,0845Maqrizi.ItticazHunafa,0845Maqrizi,312
249108236403,2,220,Shamela0000176-ara1.completed,324,707,Shamela0000176,0845Maqrizi.ItticazHunafa,0845Maqrizi,383
94489299005,2,35,Shamela0000176-ara1.completed,750,1140,Shamela0000176,0845Maqrizi.ItticazHunafa,0845Maqrizi,390
214748555728,2,478,Shamela0000176-ara1.completed,243,967,Shamela0000176,0845Maqrizi.ItticazHunafa,0845Maqrizi,724
94489449764,2,374,Shamela0000176-ara1.completed,1092,1533,Shamela0000176,0845Maqrizi.ItticazHunafa,0845Maqrizi,441
592705655147,2,374,Shamela0000176-ara1.completed,909,1643,Shamela0000176,0845Maqrizi.ItticazHunafa,0845Maqrizi,734
94489299001,2,34,Shamela0000176-ara1.completed,1,1534,Shamela0000176,0845Maqrizi.ItticazHunafa,0845Maqrizi,1533
8589938052,2,879,Shamela19Y0145334-ara1,672,905,Shamela19Y0145334,0845Maqrizi.Muqaffa,0845Maqrizi,233
249108108275,2,879,Shamela19Y0145334-ara1,1,355,Shamela19Y0145334,0845Maqrizi.Muqaffa,0845Maqrizi,354
395137027579,2,1018,Shamela19Y0145334-ara1,1377,1560,Shamela19Y0145334,0845Maqrizi.Muqaffa,0845Maqrizi,183
326417655596,2,2875,Shamela19Y0145334-ara1,1276,1547,Shamela19Y0145334,0845Maqrizi.Muqaffa,0845Maqrizi,271
326417638466,2,1037,Shamela19Y0145334-ara1,46,1316,Shamela19Y0145334,0845Maqrizi.Muqaffa,0845Maqrizi,1270
274877911569,2,2855,Shamela19Y0145334-ara1,41,1020,Shamela19Y0145334,0845Maqrizi.Muqaffa,0845Maqrizi,979
94489449766,2,2855,Shamela19Y0145334-ara1,653,838,Shamela19Y0145334,0845Maqrizi.Muqaffa,0845Maqrizi,185
8589978312,3,2850,Shamela19Y0145334-ara1,560,1632,Shamela19Y0145334,0845Maqrizi.Muqaffa,0845Maqrizi,1072
8589978313,3,2850,Shamela19Y0145334-ara1,1,759,Shamela19Y0145334,0845Maqrizi.Muqaffa,0845Maqrizi,758
283467849130,2,1262,Shamela19Y0145334-ara1,222,440,Shamela19Y0145334,0845Maqrizi.Muqaffa,0845Maqrizi,218
103079299590,2,1123,Shamela19Y0145334-ara1,18,269,Shamela19Y0145334,0845Maqrizi.Muqaffa,0845Maqrizi,251
463856664186,2,3510,Shamela19Y0145334-ara1,761,950,Shamela19Y0145334,0845Maqrizi.Muqaffa,0845Maqrizi,189
60129544726,2,1331,Shamela19Y0145334-ara1,523,1247,Shamela19Y0145334,0845Maqrizi.Muqaffa,0845Maqrizi,724
60129544728,3,1331,Shamela19Y0145334-ara1,1,225,Shamela19Y0145334,0845Maqrizi.Muqaffa,0845Maqrizi,224
188978781470,2,856,Shamela19Y0145334-ara1,789,918,Shamela19Y0145334,0845Maqrizi.Muqaffa,0845Maqrizi,129
300647906106,2,1419,Shamela19Y0145334-ara1,405,1174,Shamela19Y0145334,0845Maqrizi.Muqaffa,0845Maqrizi,769
42949800424,3,937,Shamela19Y0145334-ara1,435,878,Shamela19Y0145334,0845Maqrizi.Muqaffa,0845Maqrizi,443
206158442856,2,1002,Shamela19Y0145334-ara1,1,878,Shamela19Y0145334,0845Maqrizi.Muqaffa,0845Maqrizi,877
34359925102,2,2817,Shamela19Y0145334-ara1,49,352,Shamela19Y0145334,0845Maqrizi.Muqaffa,0845Maqrizi,303
8589938050,2,877,Shamela19Y0145334-ara1,7,488,Shamela19Y0145334,0845Maqrizi.Muqaffa,0845Maqrizi,481
403727034939,2,674,Shamela19Y0145334-ara1,70,906,Shamela19Y0145334,0845Maqrizi.Muqaffa,0845Maqrizi,836
429496803468,2,1471,Shamela19Y0145334-ara1,130,410,Shamela19Y0145334,0845Maqrizi.Muqaffa,0845Maqrizi,280
94489328655,2,226,Shamela19Y0145334-ara1,609,1548,Shamela19Y0145334,0845Maqrizi.Muqaffa,0845Maqrizi,939
77309531370,3,1465,Shamela19Y0145334-ara1,360,1054,Shamela19Y0145334,0845Maqrizi.Muqaffa,0845Maqrizi,694
77309531373,4,1465,Shamela19Y0145334-ara1,553,876,Shamela19Y0145334,0845Maqrizi.Muqaffa,0845Maqrizi,323
463856665111,2,2029,Shamela19Y0145334-ara1,30,879,Shamela19Y0145334,0845Maqrizi.Muqaffa,0845Maqrizi,849
188978739683,2,1344,Shamela19Y0145334-ara1,320,1270,Shamela19Y0145334,0845Maqrizi.Muqaffa,0845Maqrizi,950
249108194792,2,281,Shamela19Y0145334-ara1,680,1574,Shamela19Y0145334,0845Maqrizi.Muqaffa,0845Maqrizi,894
309237817029,2,1318,Shamela19Y0145334-ara1,1,176,Shamela19Y0145334,0845Maqrizi.Muqaffa,0845Maqrizi,175
128849195502,2,1124,Shamela19Y0145334-ara1,322,846,Shamela19Y0145334,0845Maqrizi.Muqaffa,0845Maqrizi,524
231928344255,2,1345,Shamela19Y0145334-ara1,503,1291,Shamela19Y0145334,0845Maqrizi.Muqaffa,0845Maqrizi,788
188978739684,2,1345,Shamela19Y0145334-ara1,125,503,Shamela19Y0145334,0845Maqrizi.Muqaffa,0845Maqrizi,378
214748504712,2,2707,Shamela19Y0145334-ara1,998,1346,Shamela19Y0145334,0845Maqrizi.Muqaffa,0845Maqrizi,348
94489370755,3,2851,Shamela19Y0145334-ara1,184,1550,Shamela19Y0145334,0845Maqrizi.Muqaffa,0845Maqrizi,1366
94489370756,2,2851,Shamela19Y0145334-ara1,1,271,Shamela19Y0145334,0845Maqrizi.Muqaffa,0845Maqrizi,270
300647728253,2,295,Shamela19Y0145334-ara1,1,901,Shamela19Y0145334,0845Maqrizi.Muqaffa,0845Maqrizi,900
274878099685,2,1424,Shamela19Y0145334-ara1,1206,1499,Shamela19Y0145334,0845Maqrizi.Muqaffa,0845Maqrizi,293
204160,3,479,Shamela19Y0145334-ara1,572,1565,Shamela19Y0145334,0845Maqrizi.Muqaffa,0845Maqrizi,993
8590140376,2,2656,Shamela19Y0145334-ara1,179,297,Shamela19Y0145334,0845Maqrizi.Muqaffa,0845Maqrizi,118
174004,2,2852,Shamela19Y0145334-ara1,1286,1737,Shamela19Y0145334,0845Maqrizi.Muqaffa,0845Maqrizi,451
174003,2,2852,Shamela19Y0145334-ara1,632,1272,Shamela19Y0145334,0845Maqrizi.Muqaffa,0845Maqrizi,640
174005,3,2852,Shamela19Y0145334-ara1,1,384,Shamela19Y0145334,0845Maqrizi.Muqaffa,0845Maqrizi,383
174006,2,2852,Shamela19Y0145334-ara1,376,585,Shamela19Y0145334,0845Maqrizi.Muqaffa,0845Maqrizi,209
128849156516,2,1899,Shamela19Y0145334-ara1,254,1275,Shamela19Y0145334,0845Maqrizi.Muqaffa,0845Maqrizi,1021
128849156519,2,1899,Shamela19Y0145334-ara1,1,237,Shamela19Y0145334,0845Maqrizi.Muqaffa,0845Maqrizi,236
128849115481,2,2027,Shamela19Y0145334-ara1,177,1521,Shamela19Y0145334,0845Maqrizi.Muqaffa,0845Maqrizi,1344
128849115487,3,2027,Shamela19Y0145334-ara1,1101,1273,Shamela19Y0145334,0845Maqrizi.Muqaffa,0845Maqrizi,172
17179916313,3,1379,Shamela19Y0145334-ara1,978,1324,Shamela19Y0145334,0845Maqrizi.Muqaffa,0845Maqrizi,346
128849022709,2,1609,Shamela19Y0145334-ara1,44,1608,Shamela19Y0145334,0845Maqrizi.Muqaffa,0845Maqrizi,1564
566935874662,2,1605,Shamela19Y0145334-ara1,582,1071,Shamela19Y0145334,0845Maqrizi.Muqaffa,0845Maqrizi,489
197568522192,2,2857,Shamela19Y0145334-ara1,1,142,Shamela19Y0145334,0845Maqrizi.Muqaffa,0845Maqrizi,141
249108172517,2,2857,Shamela19Y0145334-ara1,169,1524,Shamela19Y0145334,0845Maqrizi.Muqaffa,0845Maqrizi,1355
188978768212,2,2860,Shamela19Y0145334-ara1,1498,1703,Shamela19Y0145334,0845Maqrizi.Muqaffa,0845Maqrizi,205
154618938985,3,2862,Shamela19Y0145334-ara1,432,1313,Shamela19Y0145334,0845Maqrizi.Muqaffa,0845Maqrizi,881
240518305453,2,1038,Shamela19Y0145334-ara1,1,897,Shamela19Y0145334,0845Maqrizi.Muqaffa,0845Maqrizi,896
71605,2,1652,Shamela19Y0145334-ara1,681,916,Shamela19Y0145334,0845Maqrizi.Muqaffa,0845Maqrizi,235
137439137487,2,284,Shamela19Y0145334-ara1,1,255,Shamela19Y0145334,0845Maqrizi.Muqaffa,0845Maqrizi,254
137439137484,2,284,Shamela19Y0145334-ara1,1,1156,Shamela19Y0145334,0845Maqrizi.Muqaffa,0845Maqrizi,1155
8589938051,2,876,Shamela19Y0145334-ara1,1221,1510,Shamela19Y0145334,0845Maqrizi.Muqaffa,0845Maqrizi,289
60129759957,3,2858,Shamela19Y0145334-ara1,596,1188,Shamela19Y0145334,0845Maqrizi.Muqaffa,0845Maqrizi,592
386547072353,2,2858,Shamela19Y0145334-ara1,6,460,Shamela19Y0145334,0845Maqrizi.Muqaffa,0845Maqrizi,454
283467899510,3,2849,Shamela19Y0145334-ara1,487,758,Shamela19Y0145334,0845Maqrizi.Muqaffa,0845Maqrizi,271
283467899509,2,2849,Shamela19Y0145334-ara1,167,758,Shamela19Y0145334,0845Maqrizi.Muqaffa,0845Maqrizi,591
42949727200,3,532,Shamela19Y0145334-ara1,283,1056,Shamela19Y0145334,0845Maqrizi.Muqaffa,0845Maqrizi,773
214748454918,2,348,Shamela19Y0145334-ara1,516,1585,Shamela19Y0145334,0845Maqrizi.Muqaffa,0845Maqrizi,1069
7637,3,1374,Shamela19Y0145334-ara1,1336,1590,Shamela19Y0145334,0845Maqrizi.Muqaffa,0845Maqrizi,254
266288012694,2,3126,Shamela19Y0145334-ara1,1056,1356,Shamela19Y0145334,0845Maqrizi.Muqaffa,0845Maqrizi,300
214748519927,2,857,Shamela19Y0145334-ara1,713,935,Shamela19Y0145334,0845Maqrizi.Muqaffa,0845Maqrizi,222
214748454917,2,349,Shamela19Y0145334-ara1,7,754,Shamela19Y0145334,0845Maqrizi.Muqaffa,0845Maqrizi,747
369367271580,2,349,Shamela19Y0145334-ara1,1,1171,Shamela19Y0145334,0845Maqrizi.Muqaffa,0845Maqrizi,1170
103079250206,2,1583,Shamela19Y0145334-ara1,1219,1624,Shamela19Y0145334,0845Maqrizi.Muqaffa,0845Maqrizi,405
128849033024,3,2856,Shamela19Y0145334-ara1,1301,1515,Shamela19Y0145334,0845Maqrizi.Muqaffa,0845Maqrizi,214
506806310778,2,2423,Shamela19Y0145334-ara1,788,1469,Shamela19Y0145334,0845Maqrizi.Muqaffa,0845Maqrizi,681
644245155445,2,2423,Shamela19Y0145334-ara1,111,1298,Shamela19Y0145334,0845Maqrizi.Muqaffa,0845Maqrizi,1187
77309428942,2,1515,Shamela19Y0145334-ara1,1219,1458,Shamela19Y0145334,0845Maqrizi.Muqaffa,0845Maqrizi,239
17179997562,2,1317,Shamela19Y0145334-ara1,1015,1134,Shamela19Y0145334,0845Maqrizi.Muqaffa,0845Maqrizi,119
309237817028,2,1317,Shamela19Y0145334-ara1,1134,1579,Shamela19Y0145334,0845Maqrizi.Muqaffa,0845Maqrizi,445
42949842140,2,1317,Shamela19Y0145334-ara1,1021,1382,Shamela19Y0145334,0845Maqrizi.Muqaffa,0845Maqrizi,361
369367373081,2,1898,Shamela19Y0145334-ara1,545,1552,Shamela19Y0145334,0845Maqrizi.Muqaffa,0845Maqrizi,1007
335007449475,2,292,Shamela19Y0145334-ara1,859,1141,Shamela19Y0145334,0845Maqrizi.Muqaffa,0845Maqrizi,282
335007449474,2,292,Shamela19Y0145334-ara1,359,755,Shamela19Y0145334,0845Maqrizi.Muqaffa,0845Maqrizi,396
446676704777,2,1908,Shamela19Y0145334-ara1,1245,1358,Shamela19Y0145334,0845Maqrizi.Muqaffa,0845Maqrizi,113
8590075552,2,1908,Shamela19Y0145334-ara1,933,1358,Shamela19Y0145334,0845Maqrizi.Muqaffa,0845Maqrizi,425
83035,3,655,Shamela19Y0145334-ara1,783,1219,Shamela19Y0145334,0845Maqrizi.Muqaffa,0845Maqrizi,436
94489340788,3,2024,Shamela19Y0145334-ara1,515,825,Shamela19Y0145334,0845Maqrizi.Muqaffa,0845Maqrizi,310
506806159863,2,833,Shamela19Y0145334-ara1,1443,1591,Shamela19Y0145334,0845Maqrizi.Muqaffa,0845Maqrizi,148
326417570309,2,1377,Shamela19Y0145334-ara1,546,1411,Shamela19Y0145334,0845Maqrizi.Muqaffa,0845Maqrizi,865
420906958016,2,2710,Shamela19Y0145334-ara1,158,1152,Shamela19Y0145334,0845Maqrizi.Muqaffa,0845Maqrizi,994
188978670317,3,1411,Shamela19Y0145334-ara1,1071,1378,Shamela19Y0145334,0845Maqrizi.Muqaffa,0845Maqrizi,307
274878079151,2,1411,Shamela19Y0145334-ara1,481,1415,Shamela19Y0145334,0845Maqrizi.Muqaffa,0845Maqrizi,934
523986186067,2,2542,Shamela19Y0145334-ara1,960,1367,Shamela19Y0145334,0845Maqrizi.Muqaffa,0845Maqrizi,407
128849115483,2,2028,Shamela19Y0145334-ara1,1,476,Shamela19Y0145334,0845Maqrizi.Muqaffa,0845Maqrizi,475
420906841867,2,2028,Shamela19Y0145334-ara1,737,1558,Shamela19Y0145334,0845Maqrizi.Muqaffa,0845Maqrizi,821
34359741052,3,1383,Shamela19Y0145334-ara1,792,1314,Shamela19Y0145334,0845Maqrizi.Muqaffa,0845Maqrizi,522
51539761479,3,1000,Shamela19Y0145334-ara1,951,1488,Shamela19Y0145334,0845Maqrizi.Muqaffa,0845Maqrizi,537
51539761477,2,1000,Shamela19Y0145334-ara1,1,171,Shamela19Y0145334,0845Maqrizi.Muqaffa,0845Maqrizi,170
51539761475,2,1000,Shamela19Y0145334-ara1,921,1488,Shamela19Y0145334,0845Maqrizi.Muqaffa,0845Maqrizi,567
197568507354,2,1557,Shamela19Y0145334-ara1,977,1189,Shamela19Y0145334,0845Maqrizi.Muqaffa,0845Maqrizi,212
249108140092,2,2854,Shamela19Y0145334-ara1,1542,1659,Shamela19Y0145334,0845Maqrizi.Muqaffa,0845Maqrizi,117
249108140090,2,2854,Shamela19Y0145334-ara1,786,1173,Shamela19Y0145334,0845Maqrizi.Muqaffa,0845Maqrizi,387
249108140091,2,2854,Shamela19Y0145334-ara1,1,177,Shamela19Y0145334,0845Maqrizi.Muqaffa,0845Maqrizi,176
154618837564,2,480,Shamela19Y0145334-ara1,759,1653,Shamela19Y0145334,0845Maqrizi.Muqaffa,0845Maqrizi,894
266288156174,2,1139,Shamela19Y0145334-ara1,1302,1552,Shamela19Y0145334,0845Maqrizi.Muqaffa,0845Maqrizi,250
163208761183,2,1982,Shamela19Y0145334-ara1,178,822,Shamela19Y0145334,0845Maqrizi.Muqaffa,0845Maqrizi,644
326417600968,2,2853,Shamela19Y0145334-ara1,1,520,Shamela19Y0145334,0845Maqrizi.Muqaffa,0845Maqrizi,519
335007461559,2,2853,Shamela19Y0145334-ara1,520,1605,Shamela19Y0145334,0845Maqrizi.Muqaffa,0845Maqrizi,1085
223338302224,3,1561,Shamela19Y0145334-ara1,1213,1595,Shamela19Y0145334,0845Maqrizi.Muqaffa,0845Maqrizi,382
42949699631,2,291,Shamela19Y0145334-ara1,419,1052,Shamela19Y0145334,0845Maqrizi.Muqaffa,0845Maqrizi,633
34359929872,5,1308,Shamela19Y0145334-ara1,224,954,Shamela19Y0145334,0845Maqrizi.Muqaffa,0845Maqrizi,730
163208937547,2,1371,Shamela19Y0145334-ara1,1138,1415,Shamela19Y0145334,0845Maqrizi.Muqaffa,0845Maqrizi,277
163208937548,2,1371,Shamela19Y0145334-ara1,1415,1552,Shamela19Y0145334,0845Maqrizi.Muqaffa,0845Maqrizi,137
51539774097,2,2592,Shamela19Y0145334-ara1,1387,1523,Shamela19Y0145334,0845Maqrizi.Muqaffa,0845Maqrizi,136
214748451260,2,2861,Shamela19Y0145334-ara1,1174,1729,Shamela19Y0145334,0845Maqrizi.Muqaffa,0845Maqrizi,555
292057840223,2,1903,Shamela19Y0145334-ara1,811,958,Shamela19Y0145334,0845Maqrizi.Muqaffa,0845Maqrizi,147
94489342836,2,282,Shamela19Y0145334-ara1,352,1044,Shamela19Y0145334,0845Maqrizi.Muqaffa,0845Maqrizi,692
335007506882,2,282,Shamela19Y0145334-ara1,1,344,Shamela19Y0145334,0845Maqrizi.Muqaffa,0845Maqrizi,343
42949780222,2,1413,Shamela19Y0145334-ara1,1301,1607,Shamela19Y0145334,0845Maqrizi.Muqaffa,0845Maqrizi,306
60129611107,3,2859,Shamela19Y0145334-ara1,143,652,Shamela19Y0145334,0845Maqrizi.Muqaffa,0845Maqrizi,509
455266595259,2,1930,Shamela19Y0145334-ara1,620,970,Shamela19Y0145334,0845Maqrizi.Muqaffa,0845Maqrizi,350
163208808823,2,1543,Shamela19Y0145334-ara1,599,1053,Shamela19Y0145334,0845Maqrizi.Muqaffa,0845Maqrizi,454
223338312145,2,1387,Shamela19Y0145334-ara1,377,844,Shamela19Y0145334,0845Maqrizi.Muqaffa,0845Maqrizi,467
352187501260,2,755,Shamela19Y0145334-ara1,1317,1470,Shamela19Y0145334,0845Maqrizi.Muqaffa,0845Maqrizi,153
438086814300,2,308,Shamela19Y0145334-ara1,12,234,Shamela19Y0145334,0845Maqrizi.Muqaffa,0845Maqrizi,222
231928431175,2,2026,Shamela19Y0145334-ara1,23,1597,Shamela19Y0145334,0845Maqrizi.Muqaffa,0845Maqrizi,1574
34359917842,2,293,Shamela19Y0145334-ara1,1,1058,Shamela19Y0145334,0845Maqrizi.Muqaffa,0845Maqrizi,1057
77309587148,3,1001,Shamela19Y0145334-ara1,1315,1607,Shamela19Y0145334,0845Maqrizi.Muqaffa,0845Maqrizi,292
343597444920,2,1001,Shamela19Y0145334-ara1,1,1202,Shamela19Y0145334,0845Maqrizi.Muqaffa,0845Maqrizi,1201
180388684720,2,2713,Shamela19Y0145334-ara1,35,1185,Shamela19Y0145334,0845Maqrizi.Muqaffa,0845Maqrizi,1150
94489340785,2,2025,Shamela19Y0145334-ara1,14,1288,Shamela19Y0145334,0845Maqrizi.Muqaffa,0845Maqrizi,1274
386547191763,2,2025,Shamela19Y0145334-ara1,14,487,Shamela19Y0145334,0845Maqrizi.Muqaffa,0845Maqrizi,473
292057953654,2,591,Shamela19Y0145334-ara1,917,1249,Shamela19Y0145334,0845Maqrizi.Muqaffa,0845Maqrizi,332
274878081006,2,870,Shamela19Y0145334-ara1,88,377,Shamela19Y0145334,0845Maqrizi.Muqaffa,0845Maqrizi,289
360777427966,3,1397,Shamela19Y0145334-ara1,267,645,Shamela19Y0145334,0845Maqrizi.Muqaffa,0845Maqrizi,378
94489299002,2,2003,Shamela19Y0145334-ara1,178,1124,Shamela19Y0145334,0845Maqrizi.Muqaffa,0845Maqrizi,946
240518320068,2,2543,Shamela19Y0145334-ara1,706,1535,Shamela19Y0145334,0845Maqrizi.Muqaffa,0845Maqrizi,829
17180037047,2,1073,Shamela19Y0145334-ara1,1443,1579,Shamela19Y0145334,0845Maqrizi.Muqaffa,0845Maqrizi,136
446676736859,2,1081,Shamela19Y0145334-ara1,362,930,Shamela19Y0145334,0845Maqrizi.Muqaffa,0845Maqrizi,568
283467847091,2,2873,Shamela19Y0145334-ara1,4,830,Shamela19Y0145334,0845Maqrizi.Muqaffa,0845Maqrizi,826
300647728254,2,294,Shamela19Y0145334-ara1,937,1608,Shamela19Y0145334,0845Maqrizi.Muqaffa,0845Maqrizi,671
283467924599,2,673,Shamela19Y0145334-ara1,600,1490,Shamela19Y0145334,0845Maqrizi.Muqaffa,0845Maqrizi,890
541166012669,3,1125,Shamela19Y0145334-ara1,459,1044,Shamela19Y0145334,0845Maqrizi.Muqaffa,0845Maqrizi,585
85899536348,2,2073,Shamela19Y0145334-ara1,528,1448,Shamela19Y0145334,0845Maqrizi.Muqaffa,0845Maqrizi,920
111669202307,2,1559,Shamela19Y0145334-ara1,804,1166,Shamela19Y0145334,0845Maqrizi.Muqaffa,0845Maqrizi,362
25769895358,2,2872,Shamela19Y0145334-ara1,240,728,Shamela19Y0145334,0845Maqrizi.Muqaffa,0845Maqrizi,488
34359872557,2,1126,Shamela19Y0145334-ara1,169,984,Shamela19Y0145334,0845Maqrizi.Muqaffa,0845Maqrizi,815
94489420471,2,2719,Shamela19Y0145334-ara1,22,239,Shamela19Y0145334,0845Maqrizi.Muqaffa,0845Maqrizi,217
292057860625,2,1656,Shamela19Y0145334-ara1,874,1480,Shamela19Y0145334,0845Maqrizi.Muqaffa,0845Maqrizi,606
352187391547,2,1656,Shamela19Y0145334-ara1,648,1007,Shamela19Y0145334,0845Maqrizi.Muqaffa,0845Maqrizi,359
77309503329,2,999,Shamela19Y0145334-ara1,369,1467,Shamela19Y0145334,0845Maqrizi.Muqaffa,0845Maqrizi,1098
60129608772,3,1330,Shamela19Y0145334-ara1,1001,1575,Shamela19Y0145334,0845Maqrizi.Muqaffa,0845Maqrizi,574
94489313234,2,1227,Shamela19Y0145334-ara1,300,1259,Shamela19Y0145334,0845Maqrizi.Muqaffa,0845Maqrizi,959
94489299003,2,2260,Shamela19Y0145334-ara1,584,1155,Shamela19Y0145334,0845Maqrizi.Muqaffa,0845Maqrizi,571
163208817325,2,1111,Shamela19Y0145334-ara1,957,1535,Shamela19Y0145334,0845Maqrizi.Muqaffa,0845Maqrizi,578
549755960680,2,646,Shamela19Y0145334-ara1,1136,1435,Shamela19Y0145334,0845Maqrizi.Muqaffa,0845Maqrizi,299
566935792684,2,1425,Shamela19Y0145334-ara1,1,218,Shamela19Y0145334,0845Maqrizi.Muqaffa,0845Maqrizi,217
188978695918,2,3125,Shamela19Y0145334-ara1,1254,1557,Shamela19Y0145334,0845Maqrizi.Muqaffa,0845Maqrizi,303
188978695916,2,3125,Shamela19Y0145334-ara1,285,732,Shamela19Y0145334,0845Maqrizi.Muqaffa,0845Maqrizi,447
283467919187,2,194,Shamela19Y0145334-ara1,288,1039,Shamela19Y0145334,0845Maqrizi.Muqaffa,0845Maqrizi,751
128849194631,2,1127,Shamela19Y0145334-ara1,810,1124,Shamela19Y0145334,0845Maqrizi.Muqaffa,0845Maqrizi,314
420906849166,2,2766,Shamela19Y0145334-ara1,726,1552,Shamela19Y0145334,0845Maqrizi.Muqaffa,0845Maqrizi,826
34359887856,2,2017,Shamela19Y0145334-ara1,696,1562,Shamela19Y0145334,0845Maqrizi.Muqaffa,0845Maqrizi,866
180388724901,2,2800,Shamela19Y0145334-ara1,524,1371,Shamela19Y0145334,0845Maqrizi.Muqaffa,0845Maqrizi,847
85899412460,2,1737,Shamela0011566-ara1.completed,1216,1530,Shamela0011566,0845Maqrizi.Mawaciz,0845Maqrizi,314
257698120576,3,1737,Shamela0011566-ara1.completed,1,417,Shamela0011566,0845Maqrizi.Mawaciz,0845Maqrizi,416
257698120575,2,1737,Shamela0011566-ara1.completed,1,1216,Shamela0011566,0845Maqrizi.Mawaciz,0845Maqrizi,1215
128849144191,2,1765,Shamela0011566-ara1.completed,16,384,Shamela0011566,0845Maqrizi.Mawaciz,0845Maqrizi,368
644245155445,2,687,Shamela0011566-ara1.completed,599,956,Shamela0011566,0845Maqrizi.Mawaciz,0845Maqrizi,357
266288064918,2,1309,Shamela0011566-ara1.completed,611,1544,Shamela0011566,0845Maqrizi.Mawaciz,0845Maqrizi,933
369367271583,2,1092,Shamela0011566-ara1.completed,1262,1537,Shamela0011566,0845Maqrizi.Mawaciz,0845Maqrizi,275
214748454916,3,1092,Shamela0011566-ara1.completed,1,820,Shamela0011566,0845Maqrizi.Mawaciz,0845Maqrizi,819
369367271582,2,1092,Shamela0011566-ara1.completed,820,1537,Shamela0011566,0845Maqrizi.Mawaciz,0845Maqrizi,717
369367271580,2,1092,Shamela0011566-ara1.completed,362,1537,Shamela0011566,0845Maqrizi.Mawaciz,0845Maqrizi,1175
188978720103,2,1746,Shamela0011566-ara1.completed,1190,1637,Shamela0011566,0845Maqrizi.Mawaciz,0845Maqrizi,447
17179907801,2,1746,Shamela0011566-ara1.completed,1,1190,Shamela0011566,0845Maqrizi.Mawaciz,0845Maqrizi,1189
154618837564,2,1359,Shamela0011566-ara1.completed,1037,1465,Shamela0011566,0845Maqrizi.Mawaciz,0845Maqrizi,428
154618837563,2,1359,Shamela0011566-ara1.completed,1,561,Shamela0011566,0845Maqrizi.Mawaciz,0845Maqrizi,560
300647864198,2,779,Shamela0011566-ara1.completed,1,374,Shamela0011566,0845Maqrizi.Mawaciz,0845Maqrizi,373
300647864195,2,779,Shamela0011566-ara1.completed,374,1630,Shamela0011566,0845Maqrizi.Mawaciz,0845Maqrizi,1256
188978679599,2,1664,Shamela0011566-ara1.completed,1,161,Shamela0011566,0845Maqrizi.Mawaciz,0845Maqrizi,160
120259193498,2,25,Shamela0011566-ara1.completed,791,1665,Shamela0011566,0845Maqrizi.Mawaciz,0845Maqrizi,874
120259193499,2,25,Shamela0011566-ara1.completed,1,780,Shamela0011566,0845Maqrizi.Mawaciz,0845Maqrizi,779
34359897668,2,25,Shamela0011566-ara1.completed,610,791,Shamela0011566,0845Maqrizi.Mawaciz,0845Maqrizi,181
429496734083,2,1618,Shamela0011566-ara1.completed,481,1140,Shamela0011566,0845Maqrizi.Mawaciz,0845Maqrizi,659
68719670411,2,1720,Shamela0011566-ara1.completed,92,334,Shamela0011566,0845Maqrizi.Mawaciz,0845Maqrizi,242
360777449460,2,782,Shamela0011566-ara1.completed,400,1262,Shamela0011566,0845Maqrizi.Mawaciz,0845Maqrizi,862
188978781470,2,782,Shamela0011566-ara1.completed,238,367,Shamela0011566,0845Maqrizi.Mawaciz,0845Maqrizi,129
352187441854,2,782,Shamela0011566-ara1.completed,1,400,Shamela0011566,0845Maqrizi.Mawaciz,0845Maqrizi,399
128849078875,2,1768,Shamela0011566-ara1.completed,798,1005,Shamela0011566,0845Maqrizi.Mawaciz,0845Maqrizi,207
128849078874,2,1768,Shamela0011566-ara1.completed,1178,1611,Shamela0011566,0845Maqrizi.Mawaciz,0845Maqrizi,433
77309502207,2,1929,Shamela0011566-ara1.completed,587,1507,Shamela0011566,0845Maqrizi.Mawaciz,0845Maqrizi,920
77309502208,2,1929,Shamela0011566-ara1.completed,114,424,Shamela0011566,0845Maqrizi.Mawaciz,0845Maqrizi,310
63826,2,1153,Shamela0011566-ara1.completed,1,600,Shamela0011566,0845Maqrizi.Mawaciz,0845Maqrizi,599
498216261314,2,1153,Shamela0011566-ara1.completed,728,1638,Shamela0011566,0845Maqrizi.Mawaciz,0845Maqrizi,910
283467847091,2,1824,Shamela0011566-ara1.completed,782,1462,Shamela0011566,0845Maqrizi.Mawaciz,0845Maqrizi,680
300647731727,2,45,Shamela0011566-ara1.completed,1059,1516,Shamela0011566,0845Maqrizi.Mawaciz,0845Maqrizi,457
386547162068,2,1698,Shamela0011566-ara1.completed,217,497,Shamela0011566,0845Maqrizi.Mawaciz,0845Maqrizi,280
249108298311,2,597,Shamela0011566-ara1.completed,1,1206,Shamela0011566,0845Maqrizi.Mawaciz,0845Maqrizi,1205
309237795210,2,597,Shamela0011566-ara1.completed,1408,1600,Shamela0011566,0845Maqrizi.Mawaciz,0845Maqrizi,192
481036375233,2,1441,Shamela0011566-ara1.completed,1483,1616,Shamela0011566,0845Maqrizi.Mawaciz,0845Maqrizi,133
377957283145,3,1441,Shamela0011566-ara1.completed,1110,1467,Shamela0011566,0845Maqrizi.Mawaciz,0845Maqrizi,357
34359929872,5,1048,Shamela0011566-ara1.completed,279,628,Shamela0011566,0845Maqrizi.Mawaciz,0845Maqrizi,349
463856545415,2,838,Shamela0011566-ara1.completed,1199,1747,Shamela0011566,0845Maqrizi.Mawaciz,0845Maqrizi,548
377957283144,2,838,Shamela0011566-ara1.completed,6,1199,Shamela0011566,0845Maqrizi.Mawaciz,0845Maqrizi,1193
377957261939,3,838,Shamela0011566-ara1.completed,32,221,Shamela0011566,0845Maqrizi.Mawaciz,0845Maqrizi,189
326417616113,2,2186,Shamela0011566-ara1.completed,541,787,Shamela0011566,0845Maqrizi.Mawaciz,0845Maqrizi,246
326417627872,2,1730,Shamela0011566-ara1.completed,621,1514,Shamela0011566,0845Maqrizi.Mawaciz,0845Maqrizi,893
386547065392,2,1971,Shamela0011566-ara1.completed,1,460,Shamela0011566,0845Maqrizi.Mawaciz,0845Maqrizi,459
240518331527,2,487,Shamela0011566-ara1.completed,1485,1687,Shamela0011566,0845Maqrizi.Mawaciz,0845Maqrizi,202
369367226786,2,1890,Shamela0011566-ara1.completed,1,943,Shamela0011566,0845Maqrizi.Mawaciz,0845Maqrizi,942
42949770840,2,588,Shamela0011566-ara1.completed,146,1221,Shamela0011566,0845Maqrizi.Mawaciz,0845Maqrizi,1075
42949770843,2,588,Shamela0011566-ara1.completed,1228,1498,Shamela0011566,0845Maqrizi.Mawaciz,0845Maqrizi,270
42949770844,2,588,Shamela0011566-ara1.completed,1,141,Shamela0011566,0845Maqrizi.Mawaciz,0845Maqrizi,140
420906952217,2,1119,Shamela0011566-ara1.completed,830,1483,Shamela0011566,0845Maqrizi.Mawaciz,0845Maqrizi,653
34359929872,5,252,Shamela0011566-ara1.completed,1323,1677,Shamela0011566,0845Maqrizi.Mawaciz,0845Maqrizi,354
85899361317,2,135,Shamela0011566-ara1.completed,750,1038,Shamela0011566,0845Maqrizi.Mawaciz,0845Maqrizi,288
85899361314,2,135,Shamela0011566-ara1.completed,1,750,Shamela0011566,0845Maqrizi.Mawaciz,0845Maqrizi,749
8590075552,2,453,Shamela0011566-ara1.completed,899,1098,Shamela0011566,0845Maqrizi.Mawaciz,0845Maqrizi,199
25769892212,2,1600,Shamela0011566-ara1.completed,1424,1621,Shamela0011566,0845Maqrizi.Mawaciz,0845Maqrizi,197
25769892210,2,1600,Shamela0011566-ara1.completed,54,651,Shamela0011566,0845Maqrizi.Mawaciz,0845Maqrizi,597
25769826029,2,1870,Shamela0011566-ara1.completed,46,998,Shamela0011566,0845Maqrizi.Mawaciz,0845Maqrizi,952
25769826030,2,1870,Shamela0011566-ara1.completed,810,1668,Shamela0011566,0845Maqrizi.Mawaciz,0845Maqrizi,858
25769826032,3,1870,Shamela0011566-ara1.completed,1,679,Shamela0011566,0845Maqrizi.Mawaciz,0845Maqrizi,678
171798730779,2,580,Shamela0011566-ara1.completed,531,1615,Shamela0011566,0845Maqrizi.Mawaciz,0845Maqrizi,1084
171798730780,2,580,Shamela0011566-ara1.completed,1,531,Shamela0011566,0845Maqrizi.Mawaciz,0845Maqrizi,530
103079311595,2,1846,Shamela0011566-ara1.completed,91,473,Shamela0011566,0845Maqrizi.Mawaciz,0845Maqrizi,382
111669207812,2,2050,Shamela0011566-ara1.completed,15,456,Shamela0011566,0845Maqrizi.Mawaciz,0845Maqrizi,441
231928431175,2,1958,Shamela0011566-ara1.completed,8,1401,Shamela0011566,0845Maqrizi.Mawaciz,0845Maqrizi,1393
94489489834,2,837,Shamela0011566-ara1.completed,1,1102,Shamela0011566,0845Maqrizi.Mawaciz,0845Maqrizi,1101
377957283145,3,837,Shamela0011566-ara1.completed,1102,1574,Shamela0011566,0845Maqrizi.Mawaciz,0845Maqrizi,472
163208765315,2,2089,Shamela0011566-ara1.completed,225,405,Shamela0011566,0845Maqrizi.Mawaciz,0845Maqrizi,180
163208765316,2,2089,Shamela0011566-ara1.completed,1153,1518,Shamela0011566,0845Maqrizi.Mawaciz,0845Maqrizi,365
188978575509,2,2033,Shamela0011566-ara1.completed,8,558,Shamela0011566,0845Maqrizi.Mawaciz,0845Maqrizi,550
274878081006,2,2042,Shamela0011566-ara1.completed,417,595,Shamela0011566,0845Maqrizi.Mawaciz,0845Maqrizi,178
223338330654,2,29,Shamela0011566-ara1.completed,1,1003,Shamela0011566,0845Maqrizi.Mawaciz,0845Maqrizi,1002
111669251194,2,1892,Shamela0011566-ara1.completed,881,1266,Shamela0011566,0845Maqrizi.Mawaciz,0845Maqrizi,385
34359826412,2,1175,Shamela0011566-ara1.completed,890,1132,Shamela0011566,0845Maqrizi.Mawaciz,0845Maqrizi,242
174006,2,1019,Shamela0011566-ara1.completed,734,984,Shamela0011566,0845Maqrizi.Mawaciz,0845Maqrizi,250
60129595691,3,1111,Shamela0011566-ara1.completed,47,312,Shamela0011566,0845Maqrizi.Mawaciz,0845Maqrizi,265
395137139374,2,2083,Shamela0011566-ara1.completed,1470,1593,Shamela0011566,0845Maqrizi.Mawaciz,0845Maqrizi,123
257698080564,3,2075,Shamela0011566-ara1.completed,1,311,Shamela0011566,0845Maqrizi.Mawaciz,0845Maqrizi,310
463856664186,2,2075,Shamela0011566-ara1.completed,454,697,Shamela0011566,0845Maqrizi.Mawaciz,0845Maqrizi,243
51539784572,2,1993,Shamela0011566-ara1.completed,628,897,Shamela0011566,0845Maqrizi.Mawaciz,0845Maqrizi,269
584115602903,2,1182,Shamela0011566-ara1.completed,1345,1530,Shamela0011566,0845Maqrizi.Mawaciz,0845Maqrizi,185
137439098934,2,19,Shamela0011566-ara1.completed,247,1425,Shamela0011566,0845Maqrizi.Mawaciz,0845Maqrizi,1178
137439098935,2,19,Shamela0011566-ara1.completed,1,232,Shamela0011566,0845Maqrizi.Mawaciz,0845Maqrizi,231
25770005598,2,19,Shamela0011566-ara1.completed,1341,1545,Shamela0011566,0845Maqrizi.Mawaciz,0845Maqrizi,204
188978695702,4,1937,Shamela0011566-ara1.completed,1343,1553,Shamela0011566,0845Maqrizi.Mawaciz,0845Maqrizi,210
188978695696,2,1937,Shamela0011566-ara1.completed,1,1531,Shamela0011566,0845Maqrizi.Mawaciz,0845Maqrizi,1530
188978695701,3,1937,Shamela0011566-ara1.completed,985,1343,Shamela0011566,0845Maqrizi.Mawaciz,0845Maqrizi,358
111669265910,3,1937,Shamela0011566-ara1.completed,1,985,Shamela0011566,0845Maqrizi.Mawaciz,0845Maqrizi,984
77309584494,3,2181,Shamela0011566-ara1.completed,30,192,Shamela0011566,0845Maqrizi.Mawaciz,0845Maqrizi,162
214748514992,3,1114,Shamela0011566-ara1.completed,1048,1286,Shamela0011566,0845Maqrizi.Mawaciz,0845Maqrizi,238
240518305453,2,511,Shamela0011566-ara1.completed,488,1314,Shamela0011566,0845Maqrizi.Mawaciz,0845Maqrizi,826
266288176433,3,2096,Shamela0011566-ara1.completed,649,1109,Shamela0011566,0845Maqrizi.Mawaciz,0845Maqrizi,460
257698219198,2,123,Shamela0011566-ara1.completed,1,566,Shamela0011566,0845Maqrizi.Mawaciz,0845Maqrizi,565
403726957479,2,1461,Shamela0011566-ara1.completed,1145,1621,Shamela0011566,0845Maqrizi.Mawaciz,0845Maqrizi,476
223338432694,2,1626,Shamela0011566-ara1.completed,1000,1510,Shamela0011566,0845Maqrizi.Mawaciz,0845Maqrizi,510
25769881105,2,213,Shamela0011566-ara1.completed,1198,1529,Shamela0011566,0845Maqrizi.Mawaciz,0845Maqrizi,331
17179943496,2,213,Shamela0011566-ara1.completed,879,1198,Shamela0011566,0845Maqrizi.Mawaciz,0845Maqrizi,319
403727094866,2,2032,Shamela0011566-ara1.completed,677,1572,Shamela0011566,0845Maqrizi.Mawaciz,0845Maqrizi,895
618475316178,2,2032,Shamela0011566-ara1.completed,1,677,Shamela0011566,0845Maqrizi.Mawaciz,0845Maqrizi,676
60129646049,2,498,Shamela0011566-ara1.completed,968,1363,Shamela0011566,0845Maqrizi.Mawaciz,0845Maqrizi,395
128849124623,2,498,Shamela0011566-ara1.completed,8,534,Shamela0011566,0845Maqrizi.Mawaciz,0845Maqrizi,526
17180074830,2,887,Shamela0011566-ara1.completed,825,1654,Shamela0011566,0845Maqrizi.Mawaciz,0845Maqrizi,829
309237869004,2,1076,Shamela0011566-ara1.completed,334,597,Shamela0011566,0845Maqrizi.Mawaciz,0845Maqrizi,263
532576061925,2,648,Shamela0011566-ara1.completed,810,1453,Shamela0011566,0845Maqrizi.Mawaciz,0845Maqrizi,643
652835085542,2,648,Shamela0011566-ara1.completed,6,535,Shamela0011566,0845Maqrizi.Mawaciz,0845Maqrizi,529
446676798422,2,648,Shamela0011566-ara1.completed,1,810,Shamela0011566,0845Maqrizi.Mawaciz,0845Maqrizi,809
60129650948,2,972,Shamela0011566-ara1.completed,285,702,Shamela0011566,0845Maqrizi.Mawaciz,0845Maqrizi,417
300647906106,2,1470,Shamela0011566-ara1.completed,5,660,Shamela0011566,0845Maqrizi.Mawaciz,0845Maqrizi,655
292057889028,2,547,Shamela0011566-ara1.completed,488,793,Shamela0011566,0845Maqrizi.Mawaciz,0845Maqrizi,305
300647728254,2,1521,Shamela0011566-ara1.completed,1,689,Shamela0011566,0845Maqrizi.Mawaciz,0845Maqrizi,688
300647728253,2,1521,Shamela0011566-ara1.completed,689,1547,Shamela0011566,0845Maqrizi.Mawaciz,0845Maqrizi,858
283468021389,2,943,Shamela0011566-ara1.completed,1,935,Shamela0011566,0845Maqrizi.Mawaciz,0845Maqrizi,934
283468021390,2,943,Shamela0011566-ara1.completed,1248,1689,Shamela0011566,0845Maqrizi.Mawaciz,0845Maqrizi,441
455266616364,2,2258,Shamela0011566-ara1.completed,118,1037,Shamela0011566,0845Maqrizi.Mawaciz,0845Maqrizi,919
481036375231,2,839,Shamela0011566-ara1.completed,575,1686,Shamela0011566,0845Maqrizi.Mawaciz,0845Maqrizi,1111
532576110032,2,839,Shamela0011566-ara1.completed,1,308,Shamela0011566,0845Maqrizi.Mawaciz,0845Maqrizi,307
541166055675,2,1671,Shamela0011566-ara1.completed,7,871,Shamela0011566,0845Maqrizi.Mawaciz,0845Maqrizi,864
68719570656,2,1918,Shamela0011566-ara1.completed,902,1327,Shamela0011566,0845Maqrizi.Mawaciz,0845Maqrizi,425
395137069165,2,802,Shamela0011566-ara1.completed,427,888,Shamela0011566,0845Maqrizi.Mawaciz,0845Maqrizi,461
317827621293,2,802,Shamela0011566-ara1.completed,1243,1593,Shamela0011566,0845Maqrizi.Mawaciz,0845Maqrizi,350
60129684682,2,669,Shamela0011566-ara1.completed,747,1115,Shamela0011566,0845Maqrizi.Mawaciz,0845Maqrizi,368
249108108275,2,993,Shamela0011566-ara1.completed,1163,1417,Shamela0011566,0845Maqrizi.Mawaciz,0845Maqrizi,254
206158464946,2,2045,Shamela0011566-ara1.completed,1426,1556,Shamela0011566,0845Maqrizi.Mawaciz,0845Maqrizi,130
154618932269,3,2045,Shamela0011566-ara1.completed,300,589,Shamela0011566,0845Maqrizi.Mawaciz,0845Maqrizi,289
154618932267,2,2045,Shamela0011566-ara1.completed,357,895,Shamela0011566,0845Maqrizi.Mawaciz,0845Maqrizi,538
412316875704,2,1629,Shamela0011566-ara1.completed,1302,1549,Shamela0011566,0845Maqrizi.Mawaciz,0845Maqrizi,247
72325,2,590,Shamela0011566-ara1.completed,350,504,Shamela0011566,0845Maqrizi.Mawaciz,0845Maqrizi,154
8590023889,2,590,Shamela0011566-ara1.completed,709,1096,Shamela0011566,0845Maqrizi.Mawaciz,0845Maqrizi,387
8590023886,2,590,Shamela0011566-ara1.completed,1,1190,Shamela0011566,0845Maqrizi.Mawaciz,0845Maqrizi,1189
403726950459,2,577,Shamela0011566-ara1.completed,669,1609,Shamela0011566,0845Maqrizi.Mawaciz,0845Maqrizi,940
403726950460,2,577,Shamela0011566-ara1.completed,1,660,Shamela0011566,0845Maqrizi.Mawaciz,0845Maqrizi,659
369367369567,3,2044,Shamela0011566-ara1.completed,315,571,Shamela0011566,0845Maqrizi.Mawaciz,0845Maqrizi,256
266288029622,2,910,Shamela0011566-ara1.completed,973,1455,Shamela0011566,0845Maqrizi.Mawaciz,0845Maqrizi,482
249108172517,2,1082,Shamela0011566-ara1.completed,268,1715,Shamela0011566,0845Maqrizi.Mawaciz,0845Maqrizi,1447
8590079440,2,1696,Shamela0011566-ara1.completed,1333,1547,Shamela0011566,0845Maqrizi.Mawaciz,0845Maqrizi,214
154618860043,3,1614,Shamela0011566-ara1.completed,435,629,Shamela0011566,0845Maqrizi.Mawaciz,0845Maqrizi,194
180388658332,2,1614,Shamela0011566-ara1.completed,895,1549,Shamela0011566,0845Maqrizi.Mawaciz,0845Maqrizi,654
154618860041,2,1614,Shamela0011566-ara1.completed,188,637,Shamela0011566,0845Maqrizi.Mawaciz,0845Maqrizi,449
231928405987,4,171,Shamela0011566-ara1.completed,1369,1529,Shamela0011566,0845Maqrizi.Mawaciz,0845Maqrizi,160
489626493368,2,239,Shamela0011566-ara1.completed,969,1203,Shamela0011566,0845Maqrizi.Mawaciz,0845Maqrizi,234
240518382877,2,725,Shamela0011566-ara1.completed,866,1365,Shamela0011566,0845Maqrizi.Mawaciz,0845Maqrizi,499
292057953654,2,725,Shamela0011566-ara1.completed,211,549,Shamela0011566,0845Maqrizi.Mawaciz,0845Maqrizi,338
197568498548,3,1103,Shamela0011566-ara1.completed,226,657,Shamela0011566,0845Maqrizi.Mawaciz,0845Maqrizi,431
171798833426,3,1103,Shamela0011566-ara1.completed,1,264,Shamela0011566,0845Maqrizi.Mawaciz,0845Maqrizi,263
481036428048,2,507,Shamela0011566-ara1.completed,420,792,Shamela0011566,0845Maqrizi.Mawaciz,0845Maqrizi,372
128849161371,2,507,Shamela0011566-ara1.completed,5,265,Shamela0011566,0845Maqrizi.Mawaciz,0845Maqrizi,260
128849161370,2,507,Shamela0011566-ara1.completed,204,411,Shamela0011566,0845Maqrizi.Mawaciz,0845Maqrizi,207
386547158982,2,507,Shamela0011566-ara1.completed,956,1716,Shamela0011566,0845Maqrizi.Mawaciz,0845Maqrizi,760
395137004699,2,2257,Shamela0011566-ara1.completed,604,1276,Shamela0011566,0845Maqrizi.Mawaciz,0845Maqrizi,672
94489363864,2,14,Shamela0011566-ara1.completed,717,1692,Shamela0011566,0845Maqrizi.Mawaciz,0845Maqrizi,975
403727123269,2,14,Shamela0011566-ara1.completed,1,717,Shamela0011566,0845Maqrizi.Mawaciz,0845Maqrizi,716
412316951495,2,806,Shamela0011566-ara1.completed,238,1535,Shamela0011566,0845Maqrizi.Mawaciz,0845Maqrizi,1297
309237683339,2,806,Shamela0011566-ara1.completed,1,238,Shamela0011566,0845Maqrizi.Mawaciz,0845Maqrizi,237
231928380913,2,1954,Shamela0011566-ara1.completed,40,195,Shamela0011566,0845Maqrizi.Mawaciz,0845Maqrizi,155
498216216595,2,902,Shamela0011566-ara1.completed,911,1392,Shamela0011566,0845Maqrizi.Mawaciz,0845Maqrizi,481
309237862891,2,940,Shamela0011566-ara1.completed,29,561,Shamela0011566,0845Maqrizi.Mawaciz,0845Maqrizi,532
386547263731,2,940,Shamela0011566-ara1.completed,567,1101,Shamela0011566,0845Maqrizi.Mawaciz,0845Maqrizi,534
429496740612,2,940,Shamela0011566-ara1.completed,1108,1681,Shamela0011566,0845Maqrizi.Mawaciz,0845Maqrizi,573
223338349612,2,501,Shamela0011566-ara1.completed,82,369,Shamela0011566,0845Maqrizi.Mawaciz,0845Maqrizi,287
197568585297,3,1584,Shamela0011566-ara1.completed,1409,1616,Shamela0011566,0845Maqrizi.Mawaciz,0845Maqrizi,207
17179987940,3,2070,Shamela0011566-ara1.completed,1,832,Shamela0011566,0845Maqrizi.Mawaciz,0845Maqrizi,831
17180037046,2,1517,Shamela0011566-ara1.completed,653,803,Shamela0011566,0845Maqrizi.Mawaciz,0845Maqrizi,150
17180037047,2,1517,Shamela0011566-ara1.completed,1433,1588,Shamela0011566,0845Maqrizi.Mawaciz,0845Maqrizi,155
352187366410,2,351,Shamela0011566-ara1.completed,1,834,Shamela0011566,0845Maqrizi.Mawaciz,0845Maqrizi,833
523986186067,2,751,Shamela0011566-ara1.completed,686,1205,Shamela0011566,0845Maqrizi.Mawaciz,0845Maqrizi,519
506806159863,2,1306,Shamela0011566-ara1.completed,471,629,Shamela0011566,0845Maqrizi.Mawaciz,0845Maqrizi,158
386547114572,2,1899,Shamela0011566-ara1.completed,21,361,Shamela0011566,0845Maqrizi.Mawaciz,0845Maqrizi,340
326417600968,2,950,Shamela0011566-ara1.completed,1092,1676,Shamela0011566,0845Maqrizi.Mawaciz,0845Maqrizi,584
174004,2,950,Shamela0011566-ara1.completed,587,1092,Shamela0011566,0845Maqrizi.Mawaciz,0845Maqrizi,505
214748536435,2,557,Shamela0011566-ara1.completed,421,1165,Shamela0011566,0845Maqrizi.Mawaciz,0845Maqrizi,744
85899496482,2,557,Shamela0011566-ara1.completed,1137,1528,Shamela0011566,0845Maqrizi.Mawaciz,0845Maqrizi,391
206158603456,2,557,Shamela0011566-ara1.completed,1,350,Shamela0011566,0845Maqrizi.Mawaciz,0845Maqrizi,349
8590103817,2,1867,Shamela0011566-ara1.completed,1,1216,Shamela0011566,0845Maqrizi.Mawaciz,0845Maqrizi,1215
343597517480,2,1090,Shamela0011566-ara1.completed,1269,1557,Shamela0011566,0845Maqrizi.Mawaciz,0845Maqrizi,288
34359784669,2,1578,Shamela0011566-ara1.completed,802,947,Shamela0011566,0845Maqrizi.Mawaciz,0845Maqrizi,145
171798735004,2,380,Shamela0011566-ara1.completed,260,947,Shamela0011566,0845Maqrizi.Mawaciz,0845Maqrizi,687
584115712418,2,163,Shamela0011566-ara1.completed,942,1170,Shamela0011566,0845Maqrizi.Mawaciz,0845Maqrizi,228
231928344255,2,1196,Shamela0011566-ara1.completed,1,732,Shamela0011566,0845Maqrizi.Mawaciz,0845Maqrizi,731
206158616680,2,875,Shamela0011566-ara1.completed,1,260,Shamela0011566,0845Maqrizi.Mawaciz,0845Maqrizi,259
541166012669,3,875,Shamela0011566-ara1.completed,253,1018,Shamela0011566,0845Maqrizi.Mawaciz,0845Maqrizi,765
25769850484,3,2092,Shamela0011566-ara1.completed,5,191,Shamela0011566,0845Maqrizi.Mawaciz,0845Maqrizi,186
481036499603,2,1736,Shamela0011566-ara1.completed,1276,1548,Shamela0011566,0845Maqrizi.Mawaciz,0845Maqrizi,272
386547087480,3,1736,Shamela0011566-ara1.completed,1037,1548,Shamela0011566,0845Maqrizi.Mawaciz,0845Maqrizi,511
120259209581,3,1736,Shamela0011566-ara1.completed,805,1235,Shamela0011566,0845Maqrizi.Mawaciz,0845Maqrizi,430
120259209579,4,1736,Shamela0011566-ara1.completed,1,1276,Shamela0011566,0845Maqrizi.Mawaciz,0845Maqrizi,1275
94240,2,76,Shamela0011566-ara1.completed,277,520,Shamela0011566,0845Maqrizi.Mawaciz,0845Maqrizi,243
274877972035,2,1142,Shamela0011566-ara1.completed,1171,1566,Shamela0011566,0845Maqrizi.Mawaciz,0845Maqrizi,395
94489471080,2,146,Shamela0011566-ara1.completed,355,669,Shamela0011566,0845Maqrizi.Mawaciz,0845Maqrizi,314
120259099681,2,1740,Shamela0011566-ara1.completed,164,1697,Shamela0011566,0845Maqrizi.Mawaciz,0845Maqrizi,1533
472446498446,2,1740,Shamela0011566-ara1.completed,1,164,Shamela0011566,0845Maqrizi.Mawaciz,0845Maqrizi,163
214748469500,4,883,Shamela0011566-ara1.completed,94,375,Shamela0011566,0845Maqrizi.Mawaciz,0845Maqrizi,281
128849156519,2,1723,Shamela0011566-ara1.completed,1378,1620,Shamela0011566,0845Maqrizi.Mawaciz,0845Maqrizi,242
369367373081,2,1723,Shamela0011566-ara1.completed,303,1378,Shamela0011566,0845Maqrizi.Mawaciz,0845Maqrizi,1075
188978631777,2,911,Shamela0011566-ara1.completed,298,990,Shamela0011566,0845Maqrizi.Mawaciz,0845Maqrizi,692
420906810096,2,911,Shamela0011566-ara1.completed,473,1654,Shamela0011566,0845Maqrizi.Mawaciz,0845Maqrizi,1181
249108140091,2,951,Shamela0011566-ara1.completed,1417,1596,Shamela0011566,0845Maqrizi.Mawaciz,0845Maqrizi,179
335007461559,2,951,Shamela0011566-ara1.completed,1,1417,Shamela0011566,0845Maqrizi.Mawaciz,0845Maqrizi,1416
77309461859,2,1923,Shamela0011566-ara1.completed,1,1117,Shamela0011566,0845Maqrizi.Mawaciz,0845Maqrizi,1116
111669365833,2,144,Shamela0011566-ara1.completed,1,644,Shamela0011566,0845Maqrizi.Mawaciz,0845Maqrizi,643
317827687164,2,1763,Shamela0011566-ara1.completed,1004,1155,Shamela0011566,0845Maqrizi.Mawaciz,0845Maqrizi,151
100166,2,1710,Shamela0011566-ara1.completed,1,159,Shamela0011566,0845Maqrizi.Mawaciz,0845Maqrizi,158
352187339836,2,1529,Shamela0011566-ara1.completed,8,167,Shamela0011566,0845Maqrizi.Mawaciz,0845Maqrizi,159
523986214519,2,1529,Shamela0011566-ara1.completed,1,911,Shamela0011566,0845Maqrizi.Mawaciz,0845Maqrizi,910
309237838155,2,1529,Shamela0011566-ara1.completed,911,1618,Shamela0011566,0845Maqrizi.Mawaciz,0845Maqrizi,707
352187441853,2,781,Shamela0011566-ara1.completed,413,1596,Shamela0011566,0845Maqrizi.Mawaciz,0845Maqrizi,1183
463856600249,2,781,Shamela0011566-ara1.completed,1,413,Shamela0011566,0845Maqrizi.Mawaciz,0845Maqrizi,412
369367376454,2,23,Shamela0011566-ara1.completed,654,1676,Shamela0011566,0845Maqrizi.Mawaciz,0845Maqrizi,1022
240518323210,2,23,Shamela0011566-ara1.completed,1,654,Shamela0011566,0845Maqrizi.Mawaciz,0845Maqrizi,653
77309441068,2,1181,Shamela0011566-ara1.completed,107,280,Shamela0011566,0845Maqrizi.Mawaciz,0845Maqrizi,173
206158464287,2,805,Shamela0011566-ara1.completed,1,438,Shamela0011566,0845Maqrizi.Mawaciz,0845Maqrizi,437
309237683338,2,805,Shamela0011566-ara1.completed,411,1596,Shamela0011566,0845Maqrizi.Mawaciz,0845Maqrizi,1185
249108288475,2,2189,Shamela0011566-ara1.completed,934,1616,Shamela0011566,0845Maqrizi.Mawaciz,0845Maqrizi,682
377957247610,2,2189,Shamela0011566-ara1.completed,270,915,Shamela0011566,0845Maqrizi.Mawaciz,0845Maqrizi,645
60129737749,2,1636,Shamela0011566-ara1.completed,110,678,Shamela0011566,0845Maqrizi.Mawaciz,0845Maqrizi,568
94489420471,2,2035,Shamela0011566-ara1.completed,979,1249,Shamela0011566,0845Maqrizi.Mawaciz,0845Maqrizi,270
163208917639,2,1731,Shamela0011566-ara1.completed,47,1455,Shamela0011566,0845Maqrizi.Mawaciz,0845Maqrizi,1408
360777427966,3,2115,Shamela0011566-ara1.completed,249,670,Shamela0011566,0845Maqrizi.Mawaciz,0845Maqrizi,421
103079352752,4,1436,Shamela0011566-ara1.completed,144,632,Shamela0011566,0845Maqrizi.Mawaciz,0845Maqrizi,488
17179974829,2,2047,Shamela0011566-ara1.completed,30,548,Shamela0011566,0845Maqrizi.Mawaciz,0845Maqrizi,518
42949758833,2,1931,Shamela0011566-ara1.completed,296,867,Shamela0011566,0845Maqrizi.Mawaciz,0845Maqrizi,571
231928435537,2,2184,Shamela0011566-ara1.completed,1100,1525,Shamela0011566,0845Maqrizi.Mawaciz,0845Maqrizi,425
120259094108,2,1378,Shamela0011566-ara1.completed,1282,1505,Shamela0011566,0845Maqrizi.Mawaciz,0845Maqrizi,223
266287973385,3,352,Shamela0011566-ara1.completed,1199,1544,Shamela0011566,0845Maqrizi.Mawaciz,0845Maqrizi,345
77309501268,2,2205,Shamela0011566-ara1.completed,508,949,Shamela0011566,0845Maqrizi.Mawaciz,0845Maqrizi,441
25769840921,2,425,Shamela0011566-ara1.completed,118,521,Shamela0011566,0845Maqrizi.Mawaciz,0845Maqrizi,403
137439084409,2,2091,Shamela0011566-ara1.completed,277,396,Shamela0011566,0845Maqrizi.Mawaciz,0845Maqrizi,119
77309544303,2,1107,Shamela0011566-ara1.completed,1,307,Shamela0011566,0845Maqrizi.Mawaciz,0845Maqrizi,306
240518300704,2,1078,Shamela0011566-ara1.completed,335,928,Shamela0011566,0845Maqrizi.Mawaciz,0845Maqrizi,593
223338396584,2,778,Shamela0011566-ara1.completed,879,1596,Shamela0011566,0845Maqrizi.Mawaciz,0845Maqrizi,717
8590007563,2,512,Shamela0011566-ara1.completed,992,1612,Shamela0011566,0845Maqrizi.Mawaciz,0845Maqrizi,620
8590007566,2,512,Shamela0011566-ara1.completed,557,841,Shamela0011566,0845Maqrizi.Mawaciz,0845Maqrizi,284
8590007565,2,512,Shamela0011566-ara1.completed,168,512,Shamela0011566,0845Maqrizi.Mawaciz,0845Maqrizi,344
257698040139,2,1739,Shamela0011566-ara1.completed,642,1618,Shamela0011566,0845Maqrizi.Mawaciz,0845Maqrizi,976
85899470561,2,1739,Shamela0011566-ara1.completed,86,649,Shamela0011566,0845Maqrizi.Mawaciz,0845Maqrizi,563
77309586247,2,1866,Shamela0011566-ara1.completed,10,119,Shamela0011566,0845Maqrizi.Mawaciz,0845Maqrizi,109
77309586243,3,1866,Shamela0011566-ara1.completed,96,1171,Shamela0011566,0845Maqrizi.Mawaciz,0845Maqrizi,1075
8590103823,2,1866,Shamela0011566-ara1.completed,1171,1439,Shamela0011566,0845Maqrizi.Mawaciz,0845Maqrizi,268
34359919594,2,898,Shamela0011566-ara1.completed,985,1521,Shamela0011566,0845Maqrizi.Mawaciz,0845Maqrizi,536
42949727200,3,1666,Shamela0011566-ara1.completed,1,390,Shamela0011566,0845Maqrizi.Mawaciz,0845Maqrizi,389
283467919187,2,1666,Shamela0011566-ara1.completed,914,1242,Shamela0011566,0845Maqrizi.Mawaciz,0845Maqrizi,328
34359844472,2,1135,Shamela0011566-ara1.completed,1104,1545,Shamela0011566,0845Maqrizi.Mawaciz,0845Maqrizi,441
335007544772,2,1135,Shamela0011566-ara1.completed,524,730,Shamela0011566,0845Maqrizi.Mawaciz,0845Maqrizi,206
240518182573,2,586,Shamela0011566-ara1.completed,478,1649,Shamela0011566,0845Maqrizi.Mawaciz,0845Maqrizi,1171
137439112417,2,923,Shamela0011566-ara1.completed,844,1185,Shamela0011566,0845Maqrizi.Mawaciz,0845Maqrizi,341
137439112418,2,923,Shamela0011566-ara1.completed,676,813,Shamela0011566,0845Maqrizi.Mawaciz,0845Maqrizi,137
8590125489,2,923,Shamela0011566-ara1.completed,1185,1631,Shamela0011566,0845Maqrizi.Mawaciz,0845Maqrizi,446
171798848863,3,26,Shamela0011566-ara1.completed,287,1041,Shamela0011566,0845Maqrizi.Mawaciz,0845Maqrizi,754
171798848861,2,26,Shamela0011566-ara1.completed,1,179,Shamela0011566,0845Maqrizi.Mawaciz,0845Maqrizi,178
171798848859,2,26,Shamela0011566-ara1.completed,1077,1681,Shamela0011566,0845Maqrizi.Mawaciz,0845Maqrizi,604
429496843914,2,1250,Shamela0011566-ara1.completed,60,468,Shamela0011566,0845Maqrizi.Mawaciz,0845Maqrizi,408
463856582286,2,1250,Shamela0011566-ara1.completed,1304,1594,Shamela0011566,0845Maqrizi.Mawaciz,0845Maqrizi,290
283467940971,2,858,Shamela0011566-ara1.completed,1,672,Shamela0011566,0845Maqrizi.Mawaciz,0845Maqrizi,671
206158592376,3,5,Shamela0011566-ara1.completed,1382,1490,Shamela0011566,0845Maqrizi.Mawaciz,0845Maqrizi,108
309237817028,2,191,Shamela0011566-ara1.completed,1,433,Shamela0011566,0845Maqrizi.Mawaciz,0845Maqrizi,432
309237817029,2,191,Shamela0011566-ara1.completed,433,607,Shamela0011566,0845Maqrizi.Mawaciz,0845Maqrizi,174
438086696510,2,645,Shamela0011566-ara1.completed,900,1647,Shamela0011566,0845Maqrizi.Mawaciz,0845Maqrizi,747
463856674313,2,645,Shamela0011566-ara1.completed,784,900,Shamela0011566,0845Maqrizi.Mawaciz,0845Maqrizi,116
377957277468,2,430,Shamela0011566-ara1.completed,1230,1521,Shamela0011566,0845Maqrizi.Mawaciz,0845Maqrizi,291
377957277462,3,430,Shamela0011566-ara1.completed,406,1103,Shamela0011566,0845Maqrizi.Mawaciz,0845Maqrizi,697
386547107665,2,973,Shamela0011566-ara1.completed,444,1642,Shamela0011566,0845Maqrizi.Mawaciz,0845Maqrizi,1198
120259124151,2,973,Shamela0011566-ara1.completed,205,1065,Shamela0011566,0845Maqrizi.Mawaciz,0845Maqrizi,860
386547107668,3,973,Shamela0011566-ara1.completed,1125,1628,Shamela0011566,0845Maqrizi.Mawaciz,0845Maqrizi,503
120259124154,3,973,Shamela0011566-ara1.completed,132,444,Shamela0011566,0845Maqrizi.Mawaciz,0845Maqrizi,312
68719641107,3,489,Shamela0011566-ara1.completed,225,471,Shamela0011566,0845Maqrizi.Mawaciz,0845Maqrizi,246
25769867643,2,631,Shamela0011566-ara1.completed,1438,1631,Shamela0011566,0845Maqrizi.Mawaciz,0845Maqrizi,193
77309497184,3,1868,Shamela0011566-ara1.completed,964,1504,Shamela0011566,0845Maqrizi.Mawaciz,0845Maqrizi,540
146029079854,2,1964,Shamela0011566-ara1.completed,1111,1354,Shamela0011566,0845Maqrizi.Mawaciz,0845Maqrizi,243
111669296934,3,1895,Shamela0011566-ara1.completed,51,565,Shamela0011566,0845Maqrizi.Mawaciz,0845Maqrizi,514
274878078775,4,1895,Shamela0011566-ara1.completed,453,1007,Shamela0011566,0845Maqrizi.Mawaciz,0845Maqrizi,554
8589986939,2,2107,Shamela0011566-ara1.completed,1,589,Shamela0011566,0845Maqrizi.Mawaciz,0845Maqrizi,588
300647877794,2,1044,Shamela0011566-ara1.completed,676,941,Shamela0011566,0845Maqrizi.Mawaciz,0845Maqrizi,265
154618938985,3,1044,Shamela0011566-ara1.completed,1,563,Shamela0011566,0845Maqrizi.Mawaciz,0845Maqrizi,562
163208787281,2,1834,Shamela0011566-ara1.completed,9,1590,Shamela0011566,0845Maqrizi.Mawaciz,0845Maqrizi,1581
137439037168,3,1834,Shamela0011566-ara1.completed,1,884,Shamela0011566,0845Maqrizi.Mawaciz,0845Maqrizi,883
77309555086,2,475,Shamela0011566-ara1.completed,1134,1303,Shamela0011566,0845Maqrizi.Mawaciz,0845Maqrizi,169
197568507354,2,2079,Shamela0011566-ara1.completed,324,526,Shamela0011566,0845Maqrizi.Mawaciz,0845Maqrizi,202
111669202307,2,2079,Shamela0011566-ara1.completed,1298,1605,Shamela0011566,0845Maqrizi.Mawaciz,0845Maqrizi,307
412316955134,2,35,Shamela0011566-ara1.completed,1014,1291,Shamela0011566,0845Maqrizi.Mawaciz,0845Maqrizi,277
128849134367,2,1930,Shamela0011566-ara1.completed,847,1263,Shamela0011566,0845Maqrizi.Mawaciz,0845Maqrizi,416
128849134362,2,1930,Shamela0011566-ara1.completed,1,527,Shamela0011566,0845Maqrizi.Mawaciz,0845Maqrizi,526
292057967237,2,1774,Shamela0011566-ara1.completed,1357,1606,Shamela0011566,0845Maqrizi.Mawaciz,0845Maqrizi,249
52902,2,1621,Shamela0011566-ara1.completed,115,226,Shamela0011566,0845Maqrizi.Mawaciz,0845Maqrizi,111
51539630135,2,1621,Shamela0011566-ara1.completed,179,357,Shamela0011566,0845Maqrizi.Mawaciz,0845Maqrizi,178
420906849166,2,1797,Shamela0011566-ara1.completed,573,1513,Shamela0011566,0845Maqrizi.Mawaciz,0845Maqrizi,940
163208958960,2,1683,Shamela0011566-ara1.completed,63,1548,Shamela0011566,0845Maqrizi.Mawaciz,0845Maqrizi,1485
214748519927,2,280,Shamela0011566-ara1.completed,1350,1568,Shamela0011566,0845Maqrizi.Mawaciz,0845Maqrizi,218
249108157487,4,280,Shamela0011566-ara1.completed,610,1355,Shamela0011566,0845Maqrizi.Mawaciz,0845Maqrizi,745
326417600186,2,2203,Shamela0011566-ara1.completed,1432,1554,Shamela0011566,0845Maqrizi.Mawaciz,0845Maqrizi,122
326417600187,2,2203,Shamela0011566-ara1.completed,227,627,Shamela0011566,0845Maqrizi.Mawaciz,0845Maqrizi,400
34359897664,2,21,Shamela0011566-ara1.completed,1,1100,Shamela0011566,0845Maqrizi.Mawaciz,0845Maqrizi,1099
386547087954,2,21,Shamela0011566-ara1.completed,1100,1571,Shamela0011566,0845Maqrizi.Mawaciz,0845Maqrizi,471
163208937548,2,758,Shamela0011566-ara1.completed,1,146,Shamela0011566,0845Maqrizi.Mawaciz,0845Maqrizi,145
141553,2,1729,Shamela0011566-ara1.completed,1,839,Shamela0011566,0845Maqrizi.Mawaciz,0845Maqrizi,838
94489386064,2,369,Shamela0011566-ara1.completed,794,941,Shamela0011566,0845Maqrizi.Mawaciz,0845Maqrizi,147
403726932810,2,136,Shamela0011566-ara1.completed,5,334,Shamela0011566,0845Maqrizi.Mawaciz,0845Maqrizi,329
34359946876,2,1439,Shamela0011566-ara1.completed,1128,1251,Shamela0011566,0845Maqrizi.Mawaciz,0845Maqrizi,123
223338341559,2,1934,Shamela0011566-ara1.completed,237,1651,Shamela0011566,0845Maqrizi.Mawaciz,0845Maqrizi,1414
446676788911,2,181,Shamela0011566-ara1.completed,457,1488,Shamela0011566,0845Maqrizi.Mawaciz,0845Maqrizi,1031
60129744581,5,181,Shamela0011566-ara1.completed,780,1488,Shamela0011566,0845Maqrizi.Mawaciz,0845Maqrizi,708
240518323209,2,22,Shamela0011566-ara1.completed,1138,1623,Shamela0011566,0845Maqrizi.Mawaciz,0845Maqrizi,485
352187336088,2,22,Shamela0011566-ara1.completed,1,1138,Shamela0011566,0845Maqrizi.Mawaciz,0845Maqrizi,1137
455266698825,2,2192,Shamela0011566-ara1.completed,221,1663,Shamela0011566,0845Maqrizi.Mawaciz,0845Maqrizi,1442
163208847273,2,2192,Shamela0011566-ara1.completed,7,221,Shamela0011566,0845Maqrizi.Mawaciz,0845Maqrizi,214
206158447085,2,1379,Shamela0011566-ara1.completed,506,829,Shamela0011566,0845Maqrizi.Mawaciz,0845Maqrizi,323
17179916686,2,882,Shamela0011566-ara1.completed,277,1015,Shamela0011566,0845Maqrizi.Mawaciz,0845Maqrizi,738
70711,5,882,Shamela0011566-ara1.completed,277,524,Shamela0011566,0845Maqrizi.Mawaciz,0845Maqrizi,247
8590125492,2,924,Shamela0011566-ara1.completed,8,338,Shamela0011566,0845Maqrizi.Mawaciz,0845Maqrizi,330
240518344491,3,1531,Shamela0011566-ara1.completed,8,367,Shamela0011566,0845Maqrizi.Mawaciz,0845Maqrizi,359
68719589052,3,1531,Shamela0011566-ara1.completed,281,793,Shamela0011566,0845Maqrizi.Mawaciz,0845Maqrizi,512
68719589050,2,1531,Shamela0011566-ara1.completed,367,1646,Shamela0011566,0845Maqrizi.Mawaciz,0845Maqrizi,1279
292057860625,2,1239,Shamela0011566-ara1.completed,622,1128,Shamela0011566,0845Maqrizi.Mawaciz,0845Maqrizi,506
77309609563,2,257,Shamela0011566-ara1.completed,194,509,Shamela0011566,0845Maqrizi.Mawaciz,0845Maqrizi,315
77309609565,2,257,Shamela0011566-ara1.completed,794,949,Shamela0011566,0845Maqrizi.Mawaciz,0845Maqrizi,155
42949721241,2,2200,Shamela0011566-ara1.completed,1407,1654,Shamela0011566,0845Maqrizi.Mawaciz,0845Maqrizi,247
42949721242,2,2200,Shamela0011566-ara1.completed,106,1400,Shamela0011566,0845Maqrizi.Mawaciz,0845Maqrizi,1294
309237816367,2,2199,Shamela0011566-ara1.completed,193,1657,Shamela0011566,0845Maqrizi.Mawaciz,0845Maqrizi,1464
25769874950,2,1728,Shamela0011566-ara1.completed,1391,1595,Shamela0011566,0845Maqrizi.Mawaciz,0845Maqrizi,204
85899484885,2,2087,Shamela0011566-ara1.completed,583,721,Shamela0011566,0845Maqrizi.Mawaciz,0845Maqrizi,138
34359844471,2,1764,Shamela0011566-ara1.completed,258,959,Shamela0011566,0845Maqrizi.Mawaciz,0845Maqrizi,701
326417621125,2,1764,Shamela0011566-ara1.completed,1293,1643,Shamela0011566,0845Maqrizi.Mawaciz,0845Maqrizi,350
111669178936,2,1773,Shamela0011566-ara1.completed,68,391,Shamela0011566,0845Maqrizi.Mawaciz,0845Maqrizi,323
283467890233,2,1310,Shamela0011566-ara1.completed,25,359,Shamela0011566,0845Maqrizi.Mawaciz,0845Maqrizi,334
335007487069,2,1656,Shamela0011566-ara1.completed,966,1347,Shamela0011566,0845Maqrizi.Mawaciz,0845Maqrizi,381
335007487071,2,1656,Shamela0011566-ara1.completed,190,353,Shamela0011566,0845Maqrizi.Mawaciz,0845Maqrizi,163
257698092709,2,905,Shamela0011566-ara1.completed,380,898,Shamela0011566,0845Maqrizi.Mawaciz,0845Maqrizi,518
146028936720,3,272,Shamela0011566-ara1.completed,944,1245,Shamela0011566,0845Maqrizi.Mawaciz,0845Maqrizi,301
429496766007,2,857,Shamela0011566-ara1.completed,953,1353,Shamela0011566,0845Maqrizi.Mawaciz,0845Maqrizi,400
283467940974,2,857,Shamela0011566-ara1.completed,1358,1637,Shamela0011566,0845Maqrizi.Mawaciz,0845Maqrizi,279
240518300705,2,941,Shamela0011566-ara1.completed,950,1585,Shamela0011566,0845Maqrizi.Mawaciz,0845Maqrizi,635
377957326963,2,941,Shamela0011566-ara1.completed,182,886,Shamela0011566,0845Maqrizi.Mawaciz,0845Maqrizi,704
34359853977,2,1640,Shamela0011566-ara1.completed,1060,1602,Shamela0011566,0845Maqrizi.Mawaciz,0845Maqrizi,542
146029112404,4,2098,Shamela0011566-ara1.completed,579,1121,Shamela0011566,0845Maqrizi.Mawaciz,0845Maqrizi,542
163208922541,2,938,Shamela0011566-ara1.completed,524,909,Shamela0011566,0845Maqrizi.Mawaciz,0845Maqrizi,385
60129670908,2,591,Shamela0011566-ara1.completed,110,1474,Shamela0011566,0845Maqrizi.Mawaciz,0845Maqrizi,1364
395137027579,2,749,Shamela0011566-ara1.completed,970,1174,Shamela0011566,0845Maqrizi.Mawaciz,0845Maqrizi,204
25769892211,2,1601,Shamela0011566-ara1.completed,1,188,Shamela0011566,0845Maqrizi.Mawaciz,0845Maqrizi,187
335007513542,2,1925,Shamela0011566-ara1.completed,10,313,Shamela0011566,0845Maqrizi.Mawaciz,0845Maqrizi,303
335007513537,2,1925,Shamela0011566-ara1.completed,1,1083,Shamela0011566,0845Maqrizi.Mawaciz,0845Maqrizi,1082
214748467463,2,1925,Shamela0011566-ara1.completed,1088,1514,Shamela0011566,0845Maqrizi.Mawaciz,0845Maqrizi,426
34359930720,4,1925,Shamela0011566-ara1.completed,1,821,Shamela0011566,0845Maqrizi.Mawaciz,0845Maqrizi,820
206158459670,4,1925,Shamela0011566-ara1.completed,777,1088,Shamela0011566,0845Maqrizi.Mawaciz,0845Maqrizi,311
34359826413,2,1769,Shamela0011566-ara1.completed,441,701,Shamela0011566,0845Maqrizi.Mawaciz,0845Maqrizi,260
163208967423,2,1915,Shamela0011566-ara1.completed,607,868,Shamela0011566,0845Maqrizi.Mawaciz,0845Maqrizi,261
489626280342,2,581,Shamela0011566-ara1.completed,1,510,Shamela0011566,0845Maqrizi.Mawaciz,0845Maqrizi,509
558345921246,2,581,Shamela0011566-ara1.completed,510,1628,Shamela0011566,0845Maqrizi.Mawaciz,0845Maqrizi,1118
377957261938,2,1481,Shamela0011566-ara1.completed,1,416,Shamela0011566,0845Maqrizi.Mawaciz,0845Maqrizi,415
377957261939,3,1481,Shamela0011566-ara1.completed,1,160,Shamela0011566,0845Maqrizi.Mawaciz,0845Maqrizi,159
25769820496,2,1905,Shamela0011566-ara1.completed,1336,1510,Shamela0011566,0845Maqrizi.Mawaciz,0845Maqrizi,174
103079384420,2,955,Shamela0011566-ara1.completed,1125,1334,Shamela0011566,0845Maqrizi.Mawaciz,0845Maqrizi,209
395137134267,2,585,Shamela0011566-ara1.completed,473,1627,Shamela0011566,0845Maqrizi.Mawaciz,0845Maqrizi,1154
558345815559,2,585,Shamela0011566-ara1.completed,1,473,Shamela0011566,0845Maqrizi.Mawaciz,0845Maqrizi,472
266288111078,3,585,Shamela0011566-ara1.completed,611,938,Shamela0011566,0845Maqrizi.Mawaciz,0845Maqrizi,327
206158483858,2,2206,Shamela0011566-ara1.completed,1066,1516,Shamela0011566,0845Maqrizi.Mawaciz,0845Maqrizi,450
51539816206,2,1982,Shamela0011566-ara1.completed,881,1204,Shamela0011566,0845Maqrizi.Mawaciz,0845Maqrizi,323
71605,2,324,Shamela0011566-ara1.completed,585,811,Shamela0011566,0845Maqrizi.Mawaciz,0845Maqrizi,226
249108166558,2,490,Shamela0011566-ara1.completed,1153,1444,Shamela0011566,0845Maqrizi.Mawaciz,0845Maqrizi,291
257698183082,2,1741,Shamela0011566-ara1.completed,189,1665,Shamela0011566,0845Maqrizi.Mawaciz,0845Maqrizi,1476
120259099682,2,1741,Shamela0011566-ara1.completed,1,189,Shamela0011566,0845Maqrizi.Mawaciz,0845Maqrizi,188
146028936718,3,276,Shamela0011566-ara1.completed,719,1159,Shamela0011566,0845Maqrizi.Mawaciz,0845Maqrizi,440
257698071539,2,1673,Shamela0011566-ara1.completed,1550,1676,Shamela0011566,0845Maqrizi.Mawaciz,0845Maqrizi,126
523986149819,2,2193,Shamela0011566-ara1.completed,1,502,Shamela0011566,0845Maqrizi.Mawaciz,0845Maqrizi,501
352187415979,2,2193,Shamela0011566-ara1.completed,502,1667,Shamela0011566,0845Maqrizi.Mawaciz,0845Maqrizi,1165
68719530708,2,1938,Shamela0011566-ara1.completed,1,1134,Shamela0011566,0845Maqrizi.Mawaciz,0845Maqrizi,1133
85899536348,2,1056,Shamela0011566-ara1.completed,453,1344,Shamela0011566,0845Maqrizi.Mawaciz,0845Maqrizi,891
352187337729,2,969,Shamela0011566-ara1.completed,1,649,Shamela0011566,0845Maqrizi.Mawaciz,0845Maqrizi,648
446676736859,2,2039,Shamela0011566-ara1.completed,590,1323,Shamela0011566,0845Maqrizi.Mawaciz,0845Maqrizi,733
446676704777,2,458,Shamela0011566-ara1.completed,1048,1161,Shamela0011566,0845Maqrizi.Mawaciz,0845Maqrizi,113
146028995136,2,458,Shamela0011566-ara1.completed,290,445,Shamela0011566,0845Maqrizi.Mawaciz,0845Maqrizi,155
292057840223,2,458,Shamela0011566-ara1.completed,857,1003,Shamela0011566,0845Maqrizi.Mawaciz,0845Maqrizi,146
180388724901,2,1244,Shamela0011566-ara1.completed,604,1064,Shamela0011566,0845Maqrizi.Mawaciz,0845Maqrizi,460
412317015827,2,1516,Shamela0011566-ara1.completed,109,478,Shamela0011566,0845Maqrizi.Mawaciz,0845Maqrizi,369
369367191854,3,1786,Shamela0011566-ara1.completed,627,1119,Shamela0011566,0845Maqrizi.Mawaciz,0845Maqrizi,492
455266553696,3,1786,Shamela0011566-ara1.completed,660,801,Shamela0011566,0845Maqrizi.Mawaciz,0845Maqrizi,141
369367191856,4,1786,Shamela0011566-ara1.completed,420,904,Shamela0011566,0845Maqrizi.Mawaciz,0845Maqrizi,484
17179985554,5,1786,Shamela0011566-ara1.completed,860,1084,Shamela0011566,0845Maqrizi.Mawaciz,0845Maqrizi,224
128849233677,2,1786,Shamela0011566-ara1.completed,1,627,Shamela0011566,0845Maqrizi.Mawaciz,0845Maqrizi,626
94489370901,2,423,Shamela0011566-ara1.completed,834,1602,Shamela0011566,0845Maqrizi.Mawaciz,0845Maqrizi,768
257698038588,2,1654,Shamela0011566-ara1.completed,415,884,Shamela0011566,0845Maqrizi.Mawaciz,0845Maqrizi,469
34359934596,3,1734,Shamela0011566-ara1.completed,868,1050,Shamela0011566,0845Maqrizi.Mawaciz,0845Maqrizi,182
34359934594,3,1734,Shamela0011566-ara1.completed,1106,1411,Shamela0011566,0845Maqrizi.Mawaciz,0845Maqrizi,305
34359934591,2,1734,Shamela0011566-ara1.completed,13,1647,Shamela0011566,0845Maqrizi.Mawaciz,0845Maqrizi,1634
34359934592,3,1734,Shamela0011566-ara1.completed,1,1081,Shamela0011566,0845Maqrizi.Mawaciz,0845Maqrizi,1080
34359934593,5,1734,Shamela0011566-ara1.completed,6,498,Shamela0011566,0845Maqrizi.Mawaciz,0845Maqrizi,492
223338312145,2,769,Shamela0011566-ara1.completed,173,713,Shamela0011566,0845Maqrizi.Mawaciz,0845Maqrizi,540
438086737593,2,1533,Shamela0011566-ara1.completed,1,896,Shamela0011566,0845Maqrizi.Mawaciz,0845Maqrizi,895
438086737594,2,1533,Shamela0011566-ara1.completed,896,1242,Shamela0011566,0845Maqrizi.Mawaciz,0845Maqrizi,346
171798825724,2,798,Shamela0011566-ara1.completed,23,589,Shamela0011566,0845Maqrizi.Mawaciz,0845Maqrizi,566
85899450327,2,780,Shamela0011566-ara1.completed,1,388,Shamela0011566,0845Maqrizi.Mawaciz,0845Maqrizi,387
85899450326,2,780,Shamela0011566-ara1.completed,388,1625,Shamela0011566,0845Maqrizi.Mawaciz,0845Maqrizi,1237
188978695918,2,714,Shamela0011566-ara1.completed,425,544,Shamela0011566,0845Maqrizi.Mawaciz,0845Maqrizi,119
188978695916,2,714,Shamela0011566-ara1.completed,8,354,Shamela0011566,0845Maqrizi.Mawaciz,0845Maqrizi,346
25769953020,3,1102,Shamela0011566-ara1.completed,1463,1695,Shamela0011566,0845Maqrizi.Mawaciz,0845Maqrizi,232
25769953019,2,1102,Shamela0011566-ara1.completed,1243,1695,Shamela0011566,0845Maqrizi.Mawaciz,0845Maqrizi,452
197949,2,2102,Shamela0011566-ara1.completed,426,1154,Shamela0011566,0845Maqrizi.Mawaciz,0845Maqrizi,728
188978705077,3,646,Shamela0011566-ara1.completed,157,871,Shamela0011566,0845Maqrizi.Mawaciz,0845Maqrizi,714
283467963815,2,646,Shamela0011566-ara1.completed,1,871,Shamela0011566,0845Maqrizi.Mawaciz,0845Maqrizi,870
103079274210,2,646,Shamela0011566-ara1.completed,871,1634,Shamela0011566,0845Maqrizi.Mawaciz,0845Maqrizi,763
68719510243,3,646,Shamela0011566-ara1.completed,1110,1565,Shamela0011566,0845Maqrizi.Mawaciz,0845Maqrizi,455
188978658769,3,646,Shamela0011566-ara1.completed,157,613,Shamela0011566,0845Maqrizi.Mawaciz,0845Maqrizi,456
395137095489,2,2210,Shamela0011566-ara1.completed,588,886,Shamela0011566,0845Maqrizi.Mawaciz,0845Maqrizi,298
549755960680,2,2210,Shamela0011566-ara1.completed,1250,1455,Shamela0011566,0845Maqrizi.Mawaciz,0845Maqrizi,205
42949686974,2,610,Shamela0011566-ara1.completed,789,1597,Shamela0011566,0845Maqrizi.Mawaciz,0845Maqrizi,808
352187391547,2,1179,Shamela0011566-ara1.completed,149,624,Shamela0011566,0845Maqrizi.Mawaciz,0845Maqrizi,475
369367367149,2,1179,Shamela0011566-ara1.completed,1167,1341,Shamela0011566,0845Maqrizi.Mawaciz,0845Maqrizi,174
266288110716,2,598,Shamela0011566-ara1.completed,279,1681,Shamela0011566,0845Maqrizi.Mawaciz,0845Maqrizi,1402
266288110717,2,598,Shamela0011566-ara1.completed,1,279,Shamela0011566,0845Maqrizi.Mawaciz,0845Maqrizi,278
42949735379,2,1176,Shamela0011566-ara1.completed,406,608,Shamela0011566,0845Maqrizi.Mawaciz,0845Maqrizi,202
240518344488,2,1530,Shamela0011566-ara1.completed,605,1601,Shamela0011566,0845Maqrizi.Mawaciz,0845Maqrizi,996
249108265798,2,1530,Shamela0011566-ara1.completed,1,398,Shamela0011566,0845Maqrizi.Mawaciz,0845Maqrizi,397
249108265797,2,1530,Shamela0011566-ara1.completed,1046,1601,Shamela0011566,0845Maqrizi.Mawaciz,0845Maqrizi,555
249108265799,2,1530,Shamela0011566-ara1.completed,297,605,Shamela0011566,0845Maqrizi.Mawaciz,0845Maqrizi,308
171798842612,2,1446,Shamela0011566-ara1.completed,21,718,Shamela0011566,0845Maqrizi.Mawaciz,0845Maqrizi,697
163208878138,2,1968,Shamela0011566-ara1.completed,882,1275,Shamela0011566,0845Maqrizi.Mawaciz,0845Maqrizi,393
214748382235,2,1053,Shamela0011566-ara1.completed,1,454,Shamela0011566,0845Maqrizi.Mawaciz,0845Maqrizi,453
274877996490,2,1129,Shamela0011566-ara1.completed,240,971,Shamela0011566,0845Maqrizi.Mawaciz,0845Maqrizi,731
60129759957,3,193,Shamela0011566-ara1.completed,330,1099,Shamela0011566,0845Maqrizi.Mawaciz,0845Maqrizi,769
60129759956,2,193,Shamela0011566-ara1.completed,299,1105,Shamela0011566,0845Maqrizi.Mawaciz,0845Maqrizi,806
128849033024,3,974,Shamela0011566-ara1.completed,979,1226,Shamela0011566,0845Maqrizi.Mawaciz,0845Maqrizi,247
128849033022,2,974,Shamela0011566-ara1.completed,424,1649,Shamela0011566,0845Maqrizi.Mawaciz,0845Maqrizi,1225
128849033023,2,974,Shamela0011566-ara1.completed,1,424,Shamela0011566,0845Maqrizi.Mawaciz,0845Maqrizi,423
34359917827,2,944,Shamela0011566-ara1.completed,484,928,Shamela0011566,0845Maqrizi.Mawaciz,0845Maqrizi,444
34359754005,2,34,Shamela0011566-ara1.completed,559,827,Shamela0011566,0845Maqrizi.Mawaciz,0845Maqrizi,268
472446500905,2,1802,Shamela0011566-ara1.completed,23,1142,Shamela0011566,0845Maqrizi.Mawaciz,0845Maqrizi,1119
231928253180,2,584,Shamela0011566-ara1.completed,1,449,Shamela0011566,0845Maqrizi.Mawaciz,0845Maqrizi,448
403726941045,2,584,Shamela0011566-ara1.completed,449,1553,Shamela0011566,0845Maqrizi.Mawaciz,0845Maqrizi,1104
532576004434,2,12,Shamela0011566-ara1.completed,662,1641,Shamela0011566,0845Maqrizi.Mawaciz,0845Maqrizi,979
180388746164,2,12,Shamela0011566-ara1.completed,1,662,Shamela0011566,0845Maqrizi.Mawaciz,0845Maqrizi,661
25769806999,3,8,Shamela0011566-ara1.completed,160,718,Shamela0011566,0845Maqrizi.Mawaciz,0845Maqrizi,558
34359823204,2,701,Shamela0011566-ara1.completed,300,464,Shamela0011566,0845Maqrizi.Mawaciz,0845Maqrizi,164
34359741052,3,1146,Shamela0011566-ara1.completed,1090,1568,Shamela0011566,0845Maqrizi.Mawaciz,0845Maqrizi,478
128849072097,2,1653,Shamela0011566-ara1.completed,891,1690,Shamela0011566,0845Maqrizi.Mawaciz,0845Maqrizi,799
60129611106,2,1050,Shamela0011566-ara1.completed,10,1326,Shamela0011566,0845Maqrizi.Mawaciz,0845Maqrizi,1316
60129611107,3,1050,Shamela0011566-ara1.completed,15,729,Shamela0011566,0845Maqrizi.Mawaciz,0845Maqrizi,714
60129611108,2,1050,Shamela0011566-ara1.completed,1326,1683,Shamela0011566,0845Maqrizi.Mawaciz,0845Maqrizi,357
128849209515,2,419,Shamela0011566-ara1.completed,638,926,Shamela0011566,0845Maqrizi.Mawaciz,0845Maqrizi,288
214748555728,2,1099,Shamela0011566-ara1.completed,446,1225,Shamela0011566,0845Maqrizi.Mawaciz,0845Maqrizi,779
68719523172,2,1965,Shamela0011566-ara1.completed,214,952,Shamela0011566,0845Maqrizi.Mawaciz,0845Maqrizi,738
68719523174,2,1965,Shamela0011566-ara1.completed,109,684,Shamela0011566,0845Maqrizi.Mawaciz,0845Maqrizi,575
146029068341,2,604,Shamela0011566-ara1.completed,1,153,Shamela0011566,0845Maqrizi.Mawaciz,0845Maqrizi,152
463856674310,2,604,Shamela0011566-ara1.completed,153,983,Shamela0011566,0845Maqrizi.Mawaciz,0845Maqrizi,830
17180020039,2,1898,Shamela0011566-ara1.completed,339,1061,Shamela0011566,0845Maqrizi.Mawaciz,0845Maqrizi,722
188978775481,2,199,Shamela0011566-ara1.completed,454,630,Shamela0011566,0845Maqrizi.Mawaciz,0845Maqrizi,176
180388654251,2,199,Shamela0011566-ara1.completed,1322,1566,Shamela0011566,0845Maqrizi.Mawaciz,0845Maqrizi,244
171798693600,3,1442,Shamela0011566-ara1.completed,45,666,Shamela0011566,0845Maqrizi.Mawaciz,0845Maqrizi,621
171798693601,2,1442,Shamela0011566-ara1.completed,715,1214,Shamela0011566,0845Maqrizi.Mawaciz,0845Maqrizi,499
68719537484,2,176,Shamela0011566-ara1.completed,942,1231,Shamela0011566,0845Maqrizi.Mawaciz,0845Maqrizi,289
34359841043,2,876,Shamela0011566-ara1.completed,1,312,Shamela0011566,0845Maqrizi.Mawaciz,0845Maqrizi,311
386547072353,2,1043,Shamela0011566-ara1.completed,1122,1436,Shamela0011566,0845Maqrizi.Mawaciz,0845Maqrizi,314
335007528182,3,1043,Shamela0011566-ara1.completed,1,857,Shamela0011566,0845Maqrizi.Mawaciz,0845Maqrizi,856
8589978313,3,1043,Shamela0011566-ara1.completed,487,985,Shamela0011566,0845Maqrizi.Mawaciz,0845Maqrizi,498
25769934855,2,513,Shamela0011566-ara1.completed,911,1473,Shamela0011566,0845Maqrizi.Mawaciz,0845Maqrizi,562
25769934857,2,513,Shamela0011566-ara1.completed,316,624,Shamela0011566,0845Maqrizi.Mawaciz,0845Maqrizi,308
42949863499,11,53,Shamela0011566-ara1.completed,102,517,Shamela0011566,0845Maqrizi.Mawaciz,0845Maqrizi,415
188978739684,2,1195,Shamela0011566-ara1.completed,1344,1629,Shamela0011566,0845Maqrizi.Mawaciz,0845Maqrizi,285
188978739682,2,1195,Shamela0011566-ara1.completed,1,1134,Shamela0011566,0845Maqrizi.Mawaciz,0845Maqrizi,1133
188978739683,2,1195,Shamela0011566-ara1.completed,416,1145,Shamela0011566,0845Maqrizi.Mawaciz,0845Maqrizi,729
60129612845,2,182,Shamela0011566-ara1.completed,344,1182,Shamela0011566,0845Maqrizi.Mawaciz,0845Maqrizi,838
60129744585,7,182,Shamela0011566-ara1.completed,1,403,Shamela0011566,0845Maqrizi.Mawaciz,0845Maqrizi,402
635655294726,2,1928,Shamela0011566-ara1.completed,811,1557,Shamela0011566,0845Maqrizi.Mawaciz,0845Maqrizi,746
558345895031,2,1928,Shamela0011566-ara1.completed,91,1538,Shamela0011566,0845Maqrizi.Mawaciz,0845Maqrizi,1447
128849034762,2,502,Shamela0011566-ara1.completed,1169,1516,Shamela0011566,0845Maqrizi.Mawaciz,0845Maqrizi,347
94489342836,2,722,Shamela0011566-ara1.completed,12,606,Shamela0011566,0845Maqrizi.Mawaciz,0845Maqrizi,594
85899542118,2,582,Shamela0011566-ara1.completed,1,518,Shamela0011566,0845Maqrizi.Mawaciz,0845Maqrizi,517
85899542117,2,582,Shamela0011566-ara1.completed,525,1682,Shamela0011566,0845Maqrizi.Mawaciz,0845Maqrizi,1157
283468034521,3,1101,Shamela0011566-ara1.completed,381,714,Shamela0011566,0845Maqrizi.Mawaciz,0845Maqrizi,333
420906958016,2,1468,Shamela0011566-ara1.completed,4,923,Shamela0011566,0845Maqrizi.Mawaciz,0845Maqrizi,919
206158539301,2,473,Shamela0011566-ara1.completed,773,1535,Shamela0011566,0845Maqrizi.Mawaciz,0845Maqrizi,762
128849233673,2,1785,Shamela0011566-ara1.completed,760,1570,Shamela0011566,0845Maqrizi.Mawaciz,0845Maqrizi,810
34359919595,2,896,Shamela0011566-ara1.completed,401,996,Shamela0011566,0845Maqrizi.Mawaciz,0845Maqrizi,595
403727147792,2,896,Shamela0011566-ara1.completed,996,1323,Shamela0011566,0845Maqrizi.Mawaciz,0845Maqrizi,327
274878073977,2,2018,Shamela0011566-ara1.completed,854,1205,Shamela0011566,0845Maqrizi.Mawaciz,0845Maqrizi,351
532576122689,2,2018,Shamela0011566-ara1.completed,465,779,Shamela0011566,0845Maqrizi.Mawaciz,0845Maqrizi,314
223338302224,3,2018,Shamela0011566-ara1.completed,58,614,Shamela0011566,0845Maqrizi.Mawaciz,0845Maqrizi,556
292057925439,2,1674,Shamela0011566-ara1.completed,26,319,Shamela0011566,0845Maqrizi.Mawaciz,0845Maqrizi,293
532576097812,2,50,Shamela0011566-ara1.completed,425,748,Shamela0011566,0845Maqrizi.Mawaciz,0845Maqrizi,323
163208766903,2,243,Shamela0011566-ara1.completed,735,876,Shamela0011566,0845Maqrizi.Mawaciz,0845Maqrizi,141
292057859157,2,243,Shamela0011566-ara1.completed,1469,1643,Shamela0011566,0845Maqrizi.Mawaciz,0845Maqrizi,174
386547259004,2,243,Shamela0011566-ara1.completed,881,1476,Shamela0011566,0845Maqrizi.Mawaciz,0845Maqrizi,595
94489370756,2,996,Shamela0011566-ara1.completed,1208,1542,Shamela0011566,0845Maqrizi.Mawaciz,0845Maqrizi,334
8589978312,3,996,Shamela0011566-ara1.completed,1,1298,Shamela0011566,0845Maqrizi.Mawaciz,0845Maqrizi,1297
197568687204,2,1166,Shamela0011566-ara1.completed,865,1399,Shamela0011566,0845Maqrizi.Mawaciz,0845Maqrizi,534
60129595691,3,608,Shamela0011566-ara1.completed,748,1005,Shamela0011566,0845Maqrizi.Mawaciz,0845Maqrizi,257
283467936161,2,2090,Shamela0011566-ara1.completed,540,1057,Shamela0011566,0845Maqrizi.Mawaciz,0845Maqrizi,517
309237808413,3,2025,Shamela0011566-ara1.completed,202,678,Shamela0011566,0845Maqrizi.Mawaciz,0845Maqrizi,476
60129580395,2,2020,Shamela0011566-ara1.completed,478,818,Shamela0011566,0845Maqrizi.Mawaciz,0845Maqrizi,340
146029071223,2,1922,Shamela0011566-ara1.completed,502,742,Shamela0011566,0845Maqrizi.Mawaciz,0845Maqrizi,240
146029071224,2,1922,Shamela0011566-ara1.completed,1373,1586,Shamela0011566,0845Maqrizi.Mawaciz,0845Maqrizi,213
214748514385,2,286,Shamela0011566-ara1.completed,837,1473,Shamela0011566,0845Maqrizi.Mawaciz,0845Maqrizi,636
214748514384,2,286,Shamela0011566-ara1.completed,1,837,Shamela0011566,0845Maqrizi.Mawaciz,0845Maqrizi,836
171798746339,2,1916,Shamela0011566-ara1.completed,234,425,Shamela0011566,0845Maqrizi.Mawaciz,0845Maqrizi,191
420906841867,2,1960,Shamela0011566-ara1.completed,1,731,Shamela0011566,0845Maqrizi.Mawaciz,0845Maqrizi,730
463856665111,2,1960,Shamela0011566-ara1.completed,744,1521,Shamela0011566,0845Maqrizi.Mawaciz,0845Maqrizi,777
17179987942,2,1264,Shamela0011566-ara1.completed,1305,1636,Shamela0011566,0845Maqrizi.Mawaciz,0845Maqrizi,331
34359876695,3,514,Shamela0011566-ara1.completed,745,859,Shamela0011566,0845Maqrizi.Mawaciz,0845Maqrizi,114
240518209408,2,514,Shamela0011566-ara1.completed,322,734,Shamela0011566,0845Maqrizi.Mawaciz,0845Maqrizi,412
103079237960,3,514,Shamela0011566-ara1.completed,859,1403,Shamela0011566,0845Maqrizi.Mawaciz,0845Maqrizi,544
240518320068,2,752,Shamela0011566-ara1.completed,6,501,Shamela0011566,0845Maqrizi.Mawaciz,0845Maqrizi,495
274877952890,2,505,Shamela0011566-ara1.completed,700,1514,Shamela0011566,0845Maqrizi.Mawaciz,0845Maqrizi,814
292057867987,2,1104,Shamela0011566-ara1.completed,487,856,Shamela0011566,0845Maqrizi.Mawaciz,0845Maqrizi,369
326417519671,2,1744,Shamela0011566-ara1.completed,1,1413,Shamela0011566,0845Maqrizi.Mawaciz,0845Maqrizi,1412
68719483318,2,1744,Shamela0011566-ara1.completed,1413,1604,Shamela0011566,0845Maqrizi.Mawaciz,0845Maqrizi,191
51539725919,2,1959,Shamela0011566-ara1.completed,703,1319,Shamela0011566,0845Maqrizi.Mawaciz,0845Maqrizi,616
128849115487,3,1959,Shamela0011566-ara1.completed,737,900,Shamela0011566,0845Maqrizi.Mawaciz,0845Maqrizi,163
128849115481,2,1959,Shamela0011566-ara1.completed,1,1144,Shamela0011566,0845Maqrizi.Mawaciz,0845Maqrizi,1143
128849115483,2,1959,Shamela0011566-ara1.completed,1144,1554,Shamela0011566,0845Maqrizi.Mawaciz,0845Maqrizi,410
51539763992,2,1147,Shamela0011566-ara1.completed,59,676,Shamela0011566,0845Maqrizi.Mawaciz,0845Maqrizi,617
51539763993,2,1147,Shamela0011566-ara1.completed,1034,1399,Shamela0011566,0845Maqrizi.Mawaciz,0845Maqrizi,365
94489350486,2,1743,Shamela0011566-ara1.completed,1,196,Shamela0011566,0845Maqrizi.Mawaciz,0845Maqrizi,195
214748526809,2,1743,Shamela0011566-ara1.completed,1401,1588,Shamela0011566,0845Maqrizi.Mawaciz,0845Maqrizi,187
214748526807,2,1743,Shamela0011566-ara1.completed,1,1401,Shamela0011566,0845Maqrizi.Mawaciz,0845Maqrizi,1400
214748526808,3,1743,Shamela0011566-ara1.completed,852,1234,Shamela0011566,0845Maqrizi.Mawaciz,0845Maqrizi,382
541165921347,2,575,Shamela0011566-ara1.completed,1,728,Shamela0011566,0845Maqrizi.Mawaciz,0845Maqrizi,727
541165921346,2,575,Shamela0011566-ara1.completed,728,1607,Shamela0011566,0845Maqrizi.Mawaciz,0845Maqrizi,879
506806252654,2,603,Shamela0011566-ara1.completed,1,221,Shamela0011566,0845Maqrizi.Mawaciz,0845Maqrizi,220
146029068340,2,603,Shamela0011566-ara1.completed,199,1608,Shamela0011566,0845Maqrizi.Mawaciz,0845Maqrizi,1409
103079274209,2,647,Shamela0011566-ara1.completed,1,888,Shamela0011566,0845Maqrizi.Mawaciz,0845Maqrizi,887
446676798423,2,647,Shamela0011566-ara1.completed,888,1577,Shamela0011566,0845Maqrizi.Mawaciz,0845Maqrizi,689
652835085543,2,647,Shamela0011566-ara1.completed,1029,1484,Shamela0011566,0845Maqrizi.Mawaciz,0845Maqrizi,455
369367188858,3,459,Shamela0011566-ara1.completed,1098,1543,Shamela0011566,0845Maqrizi.Mawaciz,0845Maqrizi,445
137439162934,2,204,Shamela0011566-ara1.completed,465,1617,Shamela0011566,0845Maqrizi.Mawaciz,0845Maqrizi,1152
63827,3,1151,Shamela0011566-ara1.completed,390,853,Shamela0011566,0845Maqrizi.Mawaciz,0845Maqrizi,463
171798833421,2,975,Shamela0011566-ara1.completed,434,1271,Shamela0011566,0845Maqrizi.Mawaciz,0845Maqrizi,837
283468014070,2,652,Shamela0011566-ara1.completed,921,1643,Shamela0011566,0845Maqrizi.Mawaciz,0845Maqrizi,722
120259150971,2,652,Shamela0011566-ara1.completed,1,921,Shamela0011566,0845Maqrizi.Mawaciz,0845Maqrizi,920
128849142841,2,1766,Shamela0011566-ara1.completed,626,1052,Shamela0011566,0845Maqrizi.Mawaciz,0845Maqrizi,426
128849142840,2,1766,Shamela0011566-ara1.completed,76,626,Shamela0011566,0845Maqrizi.Mawaciz,0845Maqrizi,550
420906957293,2,500,Shamela0011566-ara1.completed,1102,1665,Shamela0011566,0845Maqrizi.Mawaciz,0845Maqrizi,563
231928352713,2,500,Shamela0011566-ara1.completed,1,1102,Shamela0011566,0845Maqrizi.Mawaciz,0845Maqrizi,1101
601295580823,2,1775,Shamela0011566-ara1.completed,562,699,Shamela0011566,0845Maqrizi.Mawaciz,0845Maqrizi,137
198404,2,1979,Shamela0011566-ara1.completed,117,702,Shamela0011566,0845Maqrizi.Mawaciz,0845Maqrizi,585
206158453467,3,1869,Shamela0011566-ara1.completed,1082,1577,Shamela0011566,0845Maqrizi.Mawaciz,0845Maqrizi,495
206158453463,2,1869,Shamela0011566-ara1.completed,610,1368,Shamela0011566,0845Maqrizi.Mawaciz,0845Maqrizi,758
472446435529,2,1869,Shamela0011566-ara1.completed,1,1082,Shamela0011566,0845Maqrizi.Mawaciz,0845Maqrizi,1081
326417744975,2,1869,Shamela0011566-ara1.completed,614,816,Shamela0011566,0845Maqrizi.Mawaciz,0845Maqrizi,202
197568661899,2,808,Shamela0011566-ara1.completed,588,731,Shamela0011566,0845Maqrizi.Mawaciz,0845Maqrizi,143
197568661898,2,808,Shamela0011566-ara1.completed,1077,1363,Shamela0011566,0845Maqrizi.Mawaciz,0845Maqrizi,286
369367345687,2,1948,Shamela0011566-ara1.completed,266,1051,Shamela0011566,0845Maqrizi.Mawaciz,0845Maqrizi,785
309237761287,2,2076,Shamela0011566-ara1.completed,94,487,Shamela0011566,0845Maqrizi.Mawaciz,0845Maqrizi,393
214748504712,2,1467,Shamela0011566-ara1.completed,264,580,Shamela0011566,0845Maqrizi.Mawaciz,0845Maqrizi,316
541166055677,2,1670,Shamela0011566-ara1.completed,1343,1614,Shamela0011566,0845Maqrizi.Mawaciz,0845Maqrizi,271
94489460026,2,1555,Shamela0011566-ara1.completed,1,803,Shamela0011566,0845Maqrizi.Mawaciz,0845Maqrizi,802
163208958959,2,1684,Shamela0011566-ara1.completed,6,1453,Shamela0011566,0845Maqrizi.Mawaciz,0845Maqrizi,1447
231928263313,2,354,Shamela0011566-ara1.completed,1148,1573,Shamela0011566,0845Maqrizi.Mawaciz,0845Maqrizi,425
231928263311,2,354,Shamela0011566-ara1.completed,1,638,Shamela0011566,0845Maqrizi.Mawaciz,0845Maqrizi,637
103079261257,2,2084,Shamela0011566-ara1.completed,1,639,Shamela0011566,0845Maqrizi.Mawaciz,0845Maqrizi,638
68719624157,2,69,Shamela0011566-ara1.completed,1,730,Shamela0011566,0845Maqrizi.Mawaciz,0845Maqrizi,729
68719624158,2,69,Shamela0011566-ara1.completed,719,1307,Shamela0011566,0845Maqrizi.Mawaciz,0845Maqrizi,588
163208802136,2,1712,Shamela0011566-ara1.completed,1333,1461,Shamela0011566,0845Maqrizi.Mawaciz,0845Maqrizi,128
77309479025,2,491,Shamela0011566-ara1.completed,421,1580,Shamela0011566,0845Maqrizi.Mawaciz,0845Maqrizi,1159
128849053697,2,491,Shamela0011566-ara1.completed,118,1146,Shamela0011566,0845Maqrizi.Mawaciz,0845Maqrizi,1028
128849053701,3,491,Shamela0011566-ara1.completed,148,421,Shamela0011566,0845Maqrizi.Mawaciz,0845Maqrizi,273
128849053698,2,491,Shamela0011566-ara1.completed,1146,1580,Shamela0011566,0845Maqrizi.Mawaciz,0845Maqrizi,434
128849053699,3,491,Shamela0011566-ara1.completed,1,326,Shamela0011566,0845Maqrizi.Mawaciz,0845Maqrizi,325
77309531121,2,967,Shamela0011566-ara1.completed,442,1053,Shamela0011566,0845Maqrizi.Mawaciz,0845Maqrizi,611
171798693600,3,840,Shamela0011566-ara1.completed,432,1076,Shamela0011566,0845Maqrizi.Mawaciz,0845Maqrizi,644
309237724398,2,840,Shamela0011566-ara1.completed,1,432,Shamela0011566,0845Maqrizi.Mawaciz,0845Maqrizi,431
171798746337,2,1906,Shamela0011566-ara1.completed,692,1272,Shamela0011566,0845Maqrizi.Mawaciz,0845Maqrizi,580
214748466821,2,1906,Shamela0011566-ara1.completed,1,136,Shamela0011566,0845Maqrizi.Mawaciz,0845Maqrizi,135
240518182576,2,587,Shamela0011566-ara1.completed,1,457,Shamela0011566,0845Maqrizi.Mawaciz,0845Maqrizi,456
335007526291,2,587,Shamela0011566-ara1.completed,457,1598,Shamela0011566,0845Maqrizi.Mawaciz,0845Maqrizi,1141
231928389249,3,1435,Shamela0011566-ara1.completed,762,1409,Shamela0011566,0845Maqrizi.Mawaciz,0845Maqrizi,647
231928389246,2,1435,Shamela0011566-ara1.completed,642,1354,Shamela0011566,0845Maqrizi.Mawaciz,0845Maqrizi,712
180388698477,3,259,Shamela0011566-ara1.completed,895,1545,Shamela0011566,0845Maqrizi.Mawaciz,0845Maqrizi,650
34359844473,2,1136,Shamela0011566-ara1.completed,1,306,Shamela0011566,0845Maqrizi.Mawaciz,0845Maqrizi,305
77309424036,2,836,Shamela0011566-ara1.completed,1151,1662,Shamela0011566,0845Maqrizi.Mawaciz,0845Maqrizi,511
77309424035,2,836,Shamela0011566-ara1.completed,107,1151,Shamela0011566,0845Maqrizi.Mawaciz,0845Maqrizi,1044
17179921461,2,506,Shamela0011566-ara1.completed,334,783,Shamela0011566,0845Maqrizi.Mawaciz,0845Maqrizi,449
223338365564,2,1401,Shamela0011566-ara1.completed,470,995,Shamela0011566,0845Maqrizi.Mawaciz,0845Maqrizi,525
274877947576,2,2201,Shamela0011566-ara1.completed,1,1357,Shamela0011566,0845Maqrizi.Mawaciz,0845Maqrizi,1356
17180033708,2,1431,Shamela0011566-ara1.completed,89,392,Shamela0011566,0845Maqrizi.Mawaciz,0845Maqrizi,303
403726991283,2,1431,Shamela0011566-ara1.completed,392,1287,Shamela0011566,0845Maqrizi.Mawaciz,0845Maqrizi,895
77309587148,3,1122,Shamela0011566-ara1.completed,1,406,Shamela0011566,0845Maqrizi.Mawaciz,0845Maqrizi,405
206158442856,2,1122,Shamela0011566-ara1.completed,301,1194,Shamela0011566,0845Maqrizi.Mawaciz,0845Maqrizi,893
188978640064,2,1924,Shamela0011566-ara1.completed,1147,1507,Shamela0011566,0845Maqrizi.Mawaciz,0845Maqrizi,360
188978640062,2,1924,Shamela0011566-ara1.completed,1,628,Shamela0011566,0845Maqrizi.Mawaciz,0845Maqrizi,627
188978640066,2,1924,Shamela0011566-ara1.completed,628,755,Shamela0011566,0845Maqrizi.Mawaciz,0845Maqrizi,127
188978640065,2,1924,Shamela0011566-ara1.completed,1343,1534,Shamela0011566,0845Maqrizi.Mawaciz,0845Maqrizi,191
188978640063,2,1924,Shamela0011566-ara1.completed,755,1147,Shamela0011566,0845Maqrizi.Mawaciz,0845Maqrizi,392
317827615952,2,1970,Shamela0011566-ara1.completed,531,1051,Shamela0011566,0845Maqrizi.Mawaciz,0845Maqrizi,520
317827615953,2,1970,Shamela0011566-ara1.completed,1222,1615,Shamela0011566,0845Maqrizi.Mawaciz,0845Maqrizi,393
17179929356,2,1545,Shamela0011566-ara1.completed,213,993,Shamela0011566,0845Maqrizi.Mawaciz,0845Maqrizi,780
85899412461,2,1732,Shamela0011566-ara1.completed,204,488,Shamela0011566,0845Maqrizi.Mawaciz,0845Maqrizi,284
51539814939,4,1732,Shamela0011566-ara1.completed,785,1466,Shamela0011566,0845Maqrizi.Mawaciz,0845Maqrizi,681
94489449018,2,1732,Shamela0011566-ara1.completed,36,1540,Shamela0011566,0845Maqrizi.Mawaciz,0845Maqrizi,1504
128849040833,2,24,Shamela0011566-ara1.completed,747,1587,Shamela0011566,0845Maqrizi.Mawaciz,0845Maqrizi,840
42949688158,4,339,Shamela0011566-ara1.completed,611,1065,Shamela0011566,0845Maqrizi.Mawaciz,0845Maqrizi,454
377957299859,2,903,Shamela0011566-ara1.completed,90,535,Shamela0011566,0845Maqrizi.Mawaciz,0845Maqrizi,445
85899490198,2,1687,Shamela0011566-ara1.completed,387,680,Shamela0011566,0845Maqrizi.Mawaciz,0845Maqrizi,293
523986038297,2,663,Shamela0011566-ara1.completed,1267,1426,Shamela0011566,0845Maqrizi.Mawaciz,0845Maqrizi,159
77309484083,2,1927,Shamela0011566-ara1.completed,13,185,Shamela0011566,0845Maqrizi.Mawaciz,0845Maqrizi,172
77309484082,2,1927,Shamela0011566-ara1.completed,185,480,Shamela0011566,0845Maqrizi.Mawaciz,0845Maqrizi,295
77309484085,2,1927,Shamela0011566-ara1.completed,13,411,Shamela0011566,0845Maqrizi.Mawaciz,0845Maqrizi,398
240518344490,2,1500,Shamela0011566-ara1.completed,1170,1619,Shamela0011566,0845Maqrizi.Mawaciz,0845Maqrizi,449
309237838158,2,1500,Shamela0011566-ara1.completed,1,294,Shamela0011566,0845Maqrizi.Mawaciz,0845Maqrizi,293
352187441855,2,1500,Shamela0011566-ara1.completed,1021,1341,Shamela0011566,0845Maqrizi.Mawaciz,0845Maqrizi,320
85899373471,2,2194,Shamela0011566-ara1.completed,667,1676,Shamela0011566,0845Maqrizi.Mawaciz,0845Maqrizi,1009
352187415980,2,2194,Shamela0011566-ara1.completed,1,657,Shamela0011566,0845Maqrizi.Mawaciz,0845Maqrizi,656
85899373472,3,2194,Shamela0011566-ara1.completed,705,1080,Shamela0011566,0845Maqrizi.Mawaciz,0845Maqrizi,375
51539675146,2,1887,Shamela0011566-ara1.completed,657,937,Shamela0011566,0845Maqrizi.Mawaciz,0845Maqrizi,280
300647785175,2,137,Shamela0011566-ara1.completed,13,171,Shamela0011566,0845Maqrizi.Mawaciz,0845Maqrizi,158
8590082493,2,914,Shamela0011566-ara1.completed,1069,1676,Shamela0011566,0845Maqrizi.Mawaciz,0845Maqrizi,607
8590082492,2,914,Shamela0011566-ara1.completed,251,986,Shamela0011566,0845Maqrizi.Mawaciz,0845Maqrizi,735
204160,3,1803,Shamela0011566-ara1.completed,36,765,Shamela0011566,0845Maqrizi.Mawaciz,0845Maqrizi,729
60129764854,3,2095,Shamela0011566-ara1.completed,1,709,Shamela0011566,0845Maqrizi.Mawaciz,0845Maqrizi,708
446676755153,2,1184,Shamela0011566-ara1.completed,142,382,Shamela0011566,0845Maqrizi.Mawaciz,0845Maqrizi,240
17179907802,2,1745,Shamela0011566-ara1.completed,1193,1679,Shamela0011566,0845Maqrizi.Mawaciz,0845Maqrizi,486
68719483316,2,1745,Shamela0011566-ara1.completed,1,1193,Shamela0011566,0845Maqrizi.Mawaciz,0845Maqrizi,1192
68719483317,3,1745,Shamela0011566-ara1.completed,1,494,Shamela0011566,0845Maqrizi.Mawaciz,0845Maqrizi,493
163208879164,2,1526,Shamela0011566-ara1.completed,358,970,Shamela0011566,0845Maqrizi.Mawaciz,0845Maqrizi,612
163208879163,2,1526,Shamela0011566-ara1.completed,1008,1678,Shamela0011566,0845Maqrizi.Mawaciz,0845Maqrizi,670
463856609004,2,2187,Shamela0011566-ara1.completed,431,1489,Shamela0011566,0845Maqrizi.Mawaciz,0845Maqrizi,1058
111669321413,2,1051,Shamela0011566-ara1.completed,1,1262,Shamela0011566,0845Maqrizi.Mawaciz,0845Maqrizi,1261
34359739554,2,815,Shamela0011566-ara1.completed,1438,1640,Shamela0011566,0845Maqrizi.Mawaciz,0845Maqrizi,202
34359885247,2,350,Shamela0011566-ara1.completed,1516,1646,Shamela0011566,0845Maqrizi.Mawaciz,0845Maqrizi,130
34359885244,2,350,Shamela0011566-ara1.completed,1,1516,Shamela0011566,0845Maqrizi.Mawaciz,0845Maqrizi,1515
94489299002,2,801,Shamela0011566-ara1.completed,450,1172,Shamela0011566,0845Maqrizi.Mawaciz,0845Maqrizi,722
94489299003,2,801,Shamela0011566-ara1.completed,901,1492,Shamela0011566,0845Maqrizi.Mawaciz,0845Maqrizi,591
94489299005,2,801,Shamela0011566-ara1.completed,1295,1540,Shamela0011566,0845Maqrizi.Mawaciz,0845Maqrizi,245
94489299001,2,801,Shamela0011566-ara1.completed,57,978,Shamela0011566,0845Maqrizi.Mawaciz,0845Maqrizi,921
180388678269,2,27,Shamela0011566-ara1.completed,1,1052,Shamela0011566,0845Maqrizi.Mawaciz,0845Maqrizi,1051
137438968378,2,27,Shamela0011566-ara1.completed,1052,1816,Shamela0011566,0845Maqrizi.Mawaciz,0845Maqrizi,764
257698205324,3,600,Shamela0011566-ara1.completed,557,1532,Shamela0011566,0845Maqrizi.Mawaciz,0845Maqrizi,975
146029052635,4,600,Shamela0011566-ara1.completed,710,1673,Shamela0011566,0845Maqrizi.Mawaciz,0845Maqrizi,963
85899524516,3,600,Shamela0011566-ara1.completed,499,710,Shamela0011566,0845Maqrizi.Mawaciz,0845Maqrizi,211
8589985926,2,600,Shamela0011566-ara1.completed,1,301,Shamela0011566,0845Maqrizi.Mawaciz,0845Maqrizi,300
257698205320,2,600,Shamela0011566-ara1.completed,301,1673,Shamela0011566,0845Maqrizi.Mawaciz,0845Maqrizi,1372
17179926282,2,1663,Shamela0011566-ara1.completed,1494,1668,Shamela0011566,0845Maqrizi.Mawaciz,0845Maqrizi,174
68719633570,2,1966,Shamela0011566-ara1.completed,119,327,Shamela0011566,0845Maqrizi.Mawaciz,0845Maqrizi,208
68719633569,2,1966,Shamela0011566-ara1.completed,431,829,Shamela0011566,0845Maqrizi.Mawaciz,0845Maqrizi,398
214748416221,2,1752,Shamela0011566-ara1.completed,739,950,Shamela0011566,0845Maqrizi.Mawaciz,0845Maqrizi,211
584115707385,2,1546,Shamela0011566-ara1.completed,431,1655,Shamela0011566,0845Maqrizi.Mawaciz,0845Maqrizi,1224
94489328655,2,405,Shamela0011566-ara1.completed,17,1080,Shamela0011566,0845Maqrizi.Mawaciz,0845Maqrizi,1063
231928379074,2,1662,Shamela0011566-ara1.completed,1133,1577,Shamela0011566,0845Maqrizi.Mawaciz,0845Maqrizi,444
146028908744,2,1926,Shamela0011566-ara1.completed,293,900,Shamela0011566,0845Maqrizi.Mawaciz,0845Maqrizi,607
386547264650,2,1926,Shamela0011566-ara1.completed,1,418,Shamela0011566,0845Maqrizi.Mawaciz,0845Maqrizi,417
146028908745,2,1926,Shamela0011566-ara1.completed,915,1582,Shamela0011566,0845Maqrizi.Mawaciz,0845Maqrizi,667
120259145256,2,503,Shamela0011566-ara1.completed,703,1595,Shamela0011566,0845Maqrizi.Mawaciz,0845Maqrizi,892
266288017363,2,287,Shamela0011566-ara1.completed,1,503,Shamela0011566,0845Maqrizi.Mawaciz,0845Maqrizi,502
532576010197,2,287,Shamela0011566-ara1.completed,426,1040,Shamela0011566,0845Maqrizi.Mawaciz,0845Maqrizi,614
77309479028,3,492,Shamela0011566-ara1.completed,1,174,Shamela0011566,0845Maqrizi.Mawaciz,0845Maqrizi,173
25769823348,2,1619,Shamela0011566-ara1.completed,1050,1233,Shamela0011566,0845Maqrizi.Mawaciz,0845Maqrizi,183
523986218980,2,1619,Shamela0011566-ara1.completed,860,1348,Shamela0011566,0845Maqrizi.Mawaciz,0845Maqrizi,488
68719677906,2,926,Shamela0011566-ara1.completed,1,569,Shamela0011566,0845Maqrizi.Mawaciz,0845Maqrizi,568
68719677907,2,926,Shamela0011566-ara1.completed,408,623,Shamela0011566,0845Maqrizi.Mawaciz,0845Maqrizi,215
60129675305,2,2121,Shamela0011566-ara1.completed,1324,1604,Shamela0011566,0845Maqrizi.Mawaciz,0845Maqrizi,280
395137137523,2,1097,Shamela0011566-ara1.completed,46,626,Shamela0011566,0845Maqrizi.Mawaciz,0845Maqrizi,580
154618858203,2,1524,Shamela0011566-ara1.completed,781,1443,Shamela0011566,0845Maqrizi.Mawaciz,0845Maqrizi,662
137439137487,2,1524,Shamela0011566-ara1.completed,271,704,Shamela0011566,0845Maqrizi.Mawaciz,0845Maqrizi,433
8589978313,3,995,Shamela0011566-ara1.completed,987,1620,Shamela0011566,0845Maqrizi.Mawaciz,0845Maqrizi,633
335007528182,3,995,Shamela0011566-ara1.completed,436,1445,Shamela0011566,0845Maqrizi.Mawaciz,0845Maqrizi,1009
506806278803,2,997,Shamela0011566-ara1.completed,1,1549,Shamela0011566,0845Maqrizi.Mawaciz,0845Maqrizi,1548
94489370755,3,997,Shamela0011566-ara1.completed,4,1190,Shamela0011566,0845Maqrizi.Mawaciz,0845Maqrizi,1186
174005,3,997,Shamela0011566-ara1.completed,1190,1556,Shamela0011566,0845Maqrizi.Mawaciz,0845Maqrizi,366
317827591705,2,2100,Shamela0011566-ara1.completed,240,418,Shamela0011566,0845Maqrizi.Mawaciz,0845Maqrizi,178
317827591706,2,2100,Shamela0011566-ara1.completed,1,485,Shamela0011566,0845Maqrizi.Mawaciz,0845Maqrizi,484
38057,2,177,Shamela0011566-ara1.completed,596,1318,Shamela0011566,0845Maqrizi.Mawaciz,0845Maqrizi,722
403727034939,2,1478,Shamela0011566-ara1.completed,835,1359,Shamela0011566,0845Maqrizi.Mawaciz,0845Maqrizi,524
283467924599,2,1478,Shamela0011566-ara1.completed,8,772,Shamela0011566,0845Maqrizi.Mawaciz,0845Maqrizi,764
412317068630,2,1478,Shamela0011566-ara1.completed,663,862,Shamela0011566,0845Maqrizi.Mawaciz,0845Maqrizi,199
146028906628,2,488,Shamela0011566-ara1.completed,777,1051,Shamela0011566,0845Maqrizi.Mawaciz,0845Maqrizi,274
283467899510,3,1042,Shamela0011566-ara1.completed,778,1251,Shamela0011566,0845Maqrizi.Mawaciz,0845Maqrizi,473
283467899509,2,1042,Shamela0011566-ara1.completed,528,1144,Shamela0011566,0845Maqrizi.Mawaciz,0845Maqrizi,616
214748451260,2,906,Shamela0011566-ara1.completed,760,1627,Shamela0011566,0845Maqrizi.Mawaciz,0845Maqrizi,867
25769923286,2,206,Shamela0011566-ara1.completed,25,724,Shamela0011566,0845Maqrizi.Mawaciz,0845Maqrizi,699
352187501260,2,483,Shamela0011566-ara1.completed,156,285,Shamela0011566,0845Maqrizi.Mawaciz,0845Maqrizi,129
51539774097,2,713,Shamela0011566-ara1.completed,491,671,Shamela0011566,0845Maqrizi.Mawaciz,0845Maqrizi,180
257698240604,2,261,Shamela0011566-ara1.completed,1,1051,Shamela0011566,0845Maqrizi.Mawaciz,0845Maqrizi,1050
223338468182,2,261,Shamela0011566-ara1.completed,1,473,Shamela0011566,0845Maqrizi.Mawaciz,0845Maqrizi,472
34359739551,2,921,Shamela0011566-ara1.completed,404,928,Shamela0011566,0845Maqrizi.Mawaciz,0845Maqrizi,524
137438966685,2,1049,Shamela0011566-ara1.completed,548,799,Shamela0011566,0845Maqrizi.Mawaciz,0845Maqrizi,251
592705655147,2,939,Shamela0011566-ara1.completed,868,1154,Shamela0011566,0845Maqrizi.Mawaciz,0845Maqrizi,286
77309426741,2,20,Shamela0011566-ara1.completed,1082,1398,Shamela0011566,0845Maqrizi.Mawaciz,0845Maqrizi,316
25770005595,2,20,Shamela0011566-ara1.completed,1,1214,Shamela0011566,0845Maqrizi.Mawaciz,0845Maqrizi,1213
34359897665,2,20,Shamela0011566-ara1.completed,1214,1729,Shamela0011566,0845Maqrizi.Mawaciz,0845Maqrizi,515
130465,2,2220,Shamela0011566-ara1.completed,106,1022,Shamela0011566,0845Maqrizi.Mawaciz,0845Maqrizi,916
25770006229,2,87,Shamela0011566-ara1.completed,537,1016,Shamela0011566,0845Maqrizi.Mawaciz,0845Maqrizi,479
25770006223,2,87,Shamela0011566-ara1.completed,1,494,Shamela0011566,0845Maqrizi.Mawaciz,0845Maqrizi,493
25770006228,2,87,Shamela0011566-ara1.completed,537,1016,Shamela0011566,0845Maqrizi.Mawaciz,0845Maqrizi,479
25770006226,2,87,Shamela0011566-ara1.completed,1034,1249,Shamela0011566,0845Maqrizi.Mawaciz,0845Maqrizi,215
171798835717,2,595,Shamela0011566-ara1.completed,1,1221,Shamela0011566,0845Maqrizi.Mawaciz,0845Maqrizi,1220
326417575203,2,595,Shamela0011566-ara1.completed,1221,1620,Shamela0011566,0845Maqrizi.Mawaciz,0845Maqrizi,399
274878074293,2,1911,Shamela0011566-ara1.completed,154,390,Shamela0011566,0845Maqrizi.Mawaciz,0845Maqrizi,236
197951,2,2103,Shamela0011566-ara1.completed,111,338,Shamela0011566,0845Maqrizi.Mawaciz,0845Maqrizi,227
352187390573,2,1615,Shamela0011566-ara1.completed,1035,1450,Shamela0011566,0845Maqrizi.Mawaciz,0845Maqrizi,415
180388658330,2,1615,Shamela0011566-ara1.completed,1,1035,Shamela0011566,0845Maqrizi.Mawaciz,0845Maqrizi,1034
197568522192,2,976,Shamela0011566-ara1.completed,954,1236,Shamela0011566,0845Maqrizi.Mawaciz,0845Maqrizi,282
60129544728,3,1154,Shamela0011566-ara1.completed,1088,1295,Shamela0011566,0845Maqrizi.Mawaciz,0845Maqrizi,207
60129608772,3,1154,Shamela0011566-ara1.completed,462,1088,Shamela0011566,0845Maqrizi.Mawaciz,0845Maqrizi,626
60129608771,2,1154,Shamela0011566-ara1.completed,358,1453,Shamela0011566,0845Maqrizi.Mawaciz,0845Maqrizi,1095
292057867988,2,952,Shamela0011566-ara1.completed,234,419,Shamela0011566,0845Maqrizi.Mawaciz,0845Maqrizi,185
249108140092,2,952,Shamela0011566-ara1.completed,71,202,Shamela0011566,0845Maqrizi.Mawaciz,0845Maqrizi,131
541165975420,2,1525,Shamela0011566-ara1.completed,515,766,Shamela0011566,0845Maqrizi.Mawaciz,0845Maqrizi,251
51539766444,2,1525,Shamela0011566-ara1.completed,766,1533,Shamela0011566,0845Maqrizi.Mawaciz,0845Maqrizi,767
214748433106,2,1148,Shamela0011566-ara1.completed,1122,1307,Shamela0011566,0845Maqrizi.Mawaciz,0845Maqrizi,185
214748433105,2,1148,Shamela0011566-ara1.completed,1319,1586,Shamela0011566,0845Maqrizi.Mawaciz,0845Maqrizi,267
94489388600,2,1148,Shamela0011566-ara1.completed,541,1155,Shamela0011566,0845Maqrizi.Mawaciz,0845Maqrizi,614
292057950548,2,1141,Shamela0011566-ara1.completed,114,629,Shamela0011566,0845Maqrizi.Mawaciz,0845Maqrizi,515
25770019845,2,1141,Shamela0011566-ara1.completed,691,993,Shamela0011566,0845Maqrizi.Mawaciz,0845Maqrizi,302
309237845590,2,9,Shamela0011566-ara1.completed,200,522,Shamela0011566,0845Maqrizi.Mawaciz,0845Maqrizi,322
154618823477,2,9,Shamela0011566-ara1.completed,200,468,Shamela0011566,0845Maqrizi.Mawaciz,0845Maqrizi,268
171798823746,2,925,Shamela0011566-ara1.completed,1149,1448,Shamela0011566,0845Maqrizi.Mawaciz,0845Maqrizi,299
42949800424,3,395,Shamela0011566-ara1.completed,1139,1654,Shamela0011566,0845Maqrizi.Mawaciz,0845Maqrizi,515
25769994872,2,1100,Shamela0011566-ara1.completed,261,1522,Shamela0011566,0845Maqrizi.Mawaciz,0845Maqrizi,1261
343597425280,2,1052,Shamela0011566-ara1.completed,1330,1646,Shamela0011566,0845Maqrizi.Mawaciz,0845Maqrizi,316
343597425279,2,1052,Shamela0011566-ara1.completed,1,1330,Shamela0011566,0845Maqrizi.Mawaciz,0845Maqrizi,1329
8590002728,2,2256,Shamela0011566-ara1.completed,138,901,Shamela0011566,0845Maqrizi.Mawaciz,0845Maqrizi,763
283467945064,2,504,Shamela0011566-ara1.completed,195,1620,Shamela0011566,0845Maqrizi.Mawaciz,0845Maqrizi,1425
420906863308,2,504,Shamela0011566-ara1.completed,1,195,Shamela0011566,0845Maqrizi.Mawaciz,0845Maqrizi,194
34359792865,4,1706,Shamela0011566-ara1.completed,533,692,Shamela0011566,0845Maqrizi.Mawaciz,0845Maqrizi,159
17179916313,3,800,Shamela0011566-ara1.completed,1123,1393,Shamela0011566,0845Maqrizi.Mawaciz,0845Maqrizi,270
171798770384,2,2059,Shamela0011566-ara1.completed,899,1332,Shamela0011566,0845Maqrizi.Mawaciz,0845Maqrizi,433
154619021109,2,2108,Shamela0011566-ara1.completed,588,1523,Shamela0011566,0845Maqrizi.Mawaciz,0845Maqrizi,935
601295556084,2,2108,Shamela0011566-ara1.completed,1528,1677,Shamela0011566,0845Maqrizi.Mawaciz,0845Maqrizi,149
17179992988,4,2077,Shamela0011566-ara1.completed,584,1042,Shamela0011566,0845Maqrizi.Mawaciz,0845Maqrizi,458
309237761289,2,2077,Shamela0011566-ara1.completed,500,754,Shamela0011566,0845Maqrizi.Mawaciz,0845Maqrizi,254
94489492727,2,1093,Shamela0011566-ara1.completed,1,858,Shamela0011566,0845Maqrizi.Mawaciz,0845Maqrizi,857
94489492728,2,1093,Shamela0011566-ara1.completed,1,319,Shamela0011566,0845Maqrizi.Mawaciz,0845Maqrizi,318
94489492729,2,1093,Shamela0011566-ara1.completed,858,1000,Shamela0011566,0845Maqrizi.Mawaciz,0845Maqrizi,142
94489424319,2,2262,Shamela0011566-ara1.completed,375,863,Shamela0011566,0845Maqrizi.Mawaciz,0845Maqrizi,488
8590140376,2,1893,Shamela0011566-ara1.completed,1452,1606,Shamela0011566,0845Maqrizi.Mawaciz,0845Maqrizi,154
60129676221,2,1893,Shamela0011566-ara1.completed,304,932,Shamela0011566,0845Maqrizi.Mawaciz,0845Maqrizi,628
77309428903,2,1893,Shamela0011566-ara1.completed,1338,1606,Shamela0011566,0845Maqrizi.Mawaciz,0845Maqrizi,268
395137112429,2,527,Shamela0011566-ara1.completed,323,512,Shamela0011566,0845Maqrizi.Mawaciz,0845Maqrizi,189
85899447711,2,2196,Shamela0011566-ara1.completed,116,455,Shamela0011566,0845Maqrizi.Mawaciz,0845Maqrizi,339
85899373474,2,2196,Shamela0011566-ara1.completed,639,921,Shamela0011566,0845Maqrizi.Mawaciz,0845Maqrizi,282
146028970705,2,2196,Shamela0011566-ara1.completed,932,1705,Shamela0011566,0845Maqrizi.Mawaciz,0845Maqrizi,773
326417667294,2,947,Shamela0011566-ara1.completed,893,1369,Shamela0011566,0845Maqrizi.Mawaciz,0845Maqrizi,476
120259168390,3,1253,Shamela0011566-ara1.completed,752,1051,Shamela0011566,0845Maqrizi.Mawaciz,0845Maqrizi,299
231928266738,2,431,Shamela0011566-ara1.completed,901,1128,Shamela0011566,0845Maqrizi.Mawaciz,0845Maqrizi,227
498216323443,2,431,Shamela0011566-ara1.completed,394,870,Shamela0011566,0845Maqrizi.Mawaciz,0845Maqrizi,476
77309428942,2,428,Shamela0011566-ara1.completed,920,1183,Shamela0011566,0845Maqrizi.Mawaciz,0845Maqrizi,263
335007575694,4,2182,Shamela0011566-ara1.completed,923,1600,Shamela0011566,0845Maqrizi.Mawaciz,0845Maqrizi,677
163208808823,2,1882,Shamela0011566-ara1.completed,1154,1367,Shamela0011566,0845Maqrizi.Mawaciz,0845Maqrizi,213
120259141782,2,88,Shamela0011566-ara1.completed,6,143,Shamela0011566,0845Maqrizi.Mawaciz,0845Maqrizi,137
174022,2,54,Shamela0011566-ara1.completed,582,1511,Shamela0011566,0845Maqrizi.Mawaciz,0845Maqrizi,929
174003,2,985,Shamela0011566-ara1.completed,1,623,Shamela0011566,0845Maqrizi.Mawaciz,0845Maqrizi,622
326417631266,2,374,Shamela0011566-ara1.completed,218,357,Shamela0011566,0845Maqrizi.Mawaciz,0845Maqrizi,139
77309481518,2,374,Shamela0011566-ara1.completed,1087,1302,Shamela0011566,0845Maqrizi.Mawaciz,0845Maqrizi,215
292057914350,2,562,Shamela0011566-ara1.completed,5,1215,Shamela0011566,0845Maqrizi.Mawaciz,0845Maqrizi,1210
8589938050,2,867,Shamela0011566-ara1.completed,569,846,Shamela0011566,0845Maqrizi.Mawaciz,0845Maqrizi,277
8589938051,2,867,Shamela0011566-ara1.completed,358,569,Shamela0011566,0845Maqrizi.Mawaciz,0845Maqrizi,211
8589938052,2,867,Shamela0011566-ara1.completed,918,1149,Shamela0011566,0845Maqrizi.Mawaciz,0845Maqrizi,231
120259150972,2,651,Shamela0011566-ara1.completed,856,1628,Shamela0011566,0845Maqrizi.Mawaciz,0845Maqrizi,772
249108127030,2,11,Shamela0011566-ara1.completed,73,633,Shamela0011566,0845Maqrizi.Mawaciz,0845Maqrizi,560
249108288474,2,2190,Shamela0011566-ara1.completed,1,1223,Shamela0011566,0845Maqrizi.Mawaciz,0845Maqrizi,1222
420906871030,2,1183,Shamela0011566-ara1.completed,281,1071,Shamela0011566,0845Maqrizi.Mawaciz,0845Maqrizi,790
292057948163,2,1582,Shamela0011566-ara1.completed,1,744,Shamela0011566,0845Maqrizi.Mawaciz,0845Maqrizi,743
94489449766,2,949,Shamela0011566-ara1.completed,975,1182,Shamela0011566,0845Maqrizi.Mawaciz,0845Maqrizi,207
94489449764,2,949,Shamela0011566-ara1.completed,96,683,Shamela0011566,0845Maqrizi.Mawaciz,0845Maqrizi,587
103079323116,2,771,Shamela0011566-ara1.completed,916,1600,Shamela0011566,0845Maqrizi.Mawaciz,0845Maqrizi,684
25769839446,4,353,Shamela0011566-ara1.completed,17,362,Shamela0011566,0845Maqrizi.Mawaciz,0845Maqrizi,345
25769839444,2,353,Shamela0011566-ara1.completed,1,550,Shamela0011566,0845Maqrizi.Mawaciz,0845Maqrizi,549
25769839442,2,353,Shamela0011566-ara1.completed,550,1520,Shamela0011566,0845Maqrizi.Mawaciz,0845Maqrizi,970
25769839443,2,353,Shamela0011566-ara1.completed,23,902,Shamela0011566,0845Maqrizi.Mawaciz,0845Maqrizi,879
25769839449,3,353,Shamela0011566-ara1.completed,902,1520,Shamela0011566,0845Maqrizi.Mawaciz,0845Maqrizi,618
17179877990,2,719,Shamela0011566-ara1.completed,708,1266,Shamela0011566,0845Maqrizi.Mawaciz,0845Maqrizi,558
137439005463,2,508,Shamela0011566-ara1.completed,265,916,Shamela0011566,0845Maqrizi.Mawaciz,0845Maqrizi,651
180388684720,2,1469,Shamela0011566-ara1.completed,435,1002,Shamela0011566,0845Maqrizi.Mawaciz,0845Maqrizi,567
283468034521,3,1485,Shamela0011566-ara1.completed,46,308,Shamela0011566,0845Maqrizi.Mawaciz,0845Maqrizi,262
25769994874,2,1485,Shamela0011566-ara1.completed,413,824,Shamela0011566,0845Maqrizi.Mawaciz,0845Maqrizi,411
395137148679,2,17,Shamela0011566-ara1.completed,928,1195,Shamela0011566,0845Maqrizi.Mawaciz,0845Maqrizi,267
395137069788,2,17,Shamela0011566-ara1.completed,746,932,Shamela0011566,0845Maqrizi.Mawaciz,0845Maqrizi,186
34359757275,2,17,Shamela0011566-ara1.completed,1,746,Shamela0011566,0845Maqrizi.Mawaciz,0845Maqrizi,745
558345784425,2,497,Shamela0011566-ara1.completed,1,1356,Shamela0011566,0845Maqrizi.Mawaciz,0845Maqrizi,1355
420907018140,2,772,Shamela0011566-ara1.completed,1,148,Shamela0011566,0845Maqrizi.Mawaciz,0845Maqrizi,147
60129640482,2,1165,Shamela0011566-ara1.completed,947,1053,Shamela0011566,0845Maqrizi.Mawaciz,0845Maqrizi,106
171798880307,2,593,Shamela0011566-ara1.completed,1,129,Shamela0011566,0845Maqrizi.Mawaciz,0845Maqrizi,128
111669211163,2,593,Shamela0011566-ara1.completed,1236,1612,Shamela0011566,0845Maqrizi.Mawaciz,0845Maqrizi,376
188978744905,2,593,Shamela0011566-ara1.completed,219,1236,Shamela0011566,0845Maqrizi.Mawaciz,0845Maqrizi,1017
429496874421,2,1686,Shamela0011566-ara1.completed,1060,1270,Shamela0011566,0845Maqrizi.Mawaciz,0845Maqrizi,210
523986100685,2,1647,Shamela0011566-ara1.completed,763,948,Shamela0011566,0845Maqrizi.Mawaciz,0845Maqrizi,185
206158558036,2,2069,Shamela0011566-ara1.completed,882,1317,Shamela0011566,0845Maqrizi.Mawaciz,0845Maqrizi,435
17179987941,3,2069,Shamela0011566-ara1.completed,1126,1633,Shamela0011566,0845Maqrizi.Mawaciz,0845Maqrizi,507
94489363865,2,15,Shamela0011566-ara1.completed,1,712,Shamela0011566,0845Maqrizi.Mawaciz,0845Maqrizi,711
506806218353,2,15,Shamela0011566-ara1.completed,712,1731,Shamela0011566,0845Maqrizi.Mawaciz,0845Maqrizi,1019
283467871674,2,1515,Shamela0011566-ara1.completed,1404,1511,Shamela0011566,0845Maqrizi.Mawaciz,0845Maqrizi,107
34359925102,2,1188,Shamela0011566-ara1.completed,800,1109,Shamela0011566,0845Maqrizi.Mawaciz,0845Maqrizi,309
266288012694,2,187,Shamela0011566-ara1.completed,605,1170,Shamela0011566,0845Maqrizi.Mawaciz,0845Maqrizi,565
103079250206,2,2111,Shamela0011566-ara1.completed,739,1208,Shamela0011566,0845Maqrizi.Mawaciz,0845Maqrizi,469
274878063120,2,1886,Shamela0011566-ara1.completed,380,701,Shamela0011566,0845Maqrizi.Mawaciz,0845Maqrizi,321
283467883786,2,408,Shamela0011566-ara1.completed,1090,1276,Shamela0011566,0845Maqrizi.Mawaciz,0845Maqrizi,186
446676610355,2,412,Shamela0011566-ara1.completed,361,543,Shamela0011566,0845Maqrizi.Mawaciz,0845Maqrizi,182
103079345279,2,1001,Shamela0011566-ara1.completed,321,497,Shamela0011566,0845Maqrizi.Mawaciz,0845Maqrizi,176
17179997562,2,190,Shamela0011566-ara1.completed,1444,1563,Shamela0011566,0845Maqrizi.Mawaciz,0845Maqrizi,119
249108140090,2,999,Shamela0011566-ara1.completed,1149,1621,Shamela0011566,0845Maqrizi.Mawaciz,0845Maqrizi,472
257698079989,2,1616,Shamela0011566-ara1.completed,7,911,Shamela0011566,0845Maqrizi.Mawaciz,0845Maqrizi,904
566935792684,2,2137,Shamela0011566-ara1.completed,447,671,Shamela0011566,0845Maqrizi.Mawaciz,0845Maqrizi,224
188978670317,3,2137,Shamela0011566-ara1.completed,874,1069,Shamela0011566,0845Maqrizi.Mawaciz,0845Maqrizi,195
274878079151,2,2137,Shamela0011566-ara1.completed,121,1124,Shamela0011566,0845Maqrizi.Mawaciz,0845Maqrizi,1003
274878099685,2,2137,Shamela0011566-ara1.completed,143,447,Shamela0011566,0845Maqrizi.Mawaciz,0845Maqrizi,304
85899404923,2,564,Shamela0011566-ara1.completed,434,1483,Shamela0011566,0845Maqrizi.Mawaciz,0845Maqrizi,1049
68719521606,2,143,Shamela0011566-ara1.completed,1,158,Shamela0011566,0845Maqrizi.Mawaciz,0845Maqrizi,157
68719521607,2,143,Shamela0011566-ara1.completed,645,1602,Shamela0011566,0845Maqrizi.Mawaciz,0845Maqrizi,957
343597444921,2,1121,Shamela0011566-ara1.completed,1,652,Shamela0011566,0845Maqrizi.Mawaciz,0845Maqrizi,651
343597444920,2,1121,Shamela0011566-ara1.completed,286,1589,Shamela0011566,0845Maqrizi.Mawaciz,0845Maqrizi,1303
214748454919,2,1527,Shamela0011566-ara1.completed,1,266,Shamela0011566,0845Maqrizi.Mawaciz,0845Maqrizi,265
214748454918,2,1527,Shamela0011566-ara1.completed,295,904,Shamela0011566,0845Maqrizi.Mawaciz,0845Maqrizi,609
214748454917,2,1527,Shamela0011566-ara1.completed,912,1489,Shamela0011566,0845Maqrizi.Mawaciz,0845Maqrizi,577
214748454920,2,1527,Shamela0011566-ara1.completed,1287,1489,Shamela0011566,0845Maqrizi.Mawaciz,0845Maqrizi,202
214748454916,3,1527,Shamela0011566-ara1.completed,278,1257,Shamela0011566,0845Maqrizi.Mawaciz,0845Maqrizi,979
25769809147,2,2219,Shamela0011566-ara1.completed,1082,1638,Shamela0011566,0845Maqrizi.Mawaciz,0845Maqrizi,556
94489340788,3,1957,Shamela0011566-ara1.completed,1,161,Shamela0011566,0845Maqrizi.Mawaciz,0845Maqrizi,160
94489340787,2,1957,Shamela0011566-ara1.completed,1130,1375,Shamela0011566,0845Maqrizi.Mawaciz,0845Maqrizi,245
94489340785,2,1957,Shamela0011566-ara1.completed,595,1611,Shamela0011566,0845Maqrizi.Mawaciz,0845Maqrizi,1016
249108214663,2,1645,Shamela0011566-ara1.completed,1102,1396,Shamela0011566,0845Maqrizi.Mawaciz,0845Maqrizi,294
180388837833,2,1501,Shamela0011566-ara1.completed,314,800,Shamela0011566,0845Maqrizi.Mawaciz,0845Maqrizi,486
412317048375,2,579,Shamela0011566-ara1.completed,611,1589,Shamela0011566,0845Maqrizi.Mawaciz,0845Maqrizi,978
412317048377,2,579,Shamela0011566-ara1.completed,484,871,Shamela0011566,0845Maqrizi.Mawaciz,0845Maqrizi,387
146029078129,2,579,Shamela0011566-ara1.completed,1,611,Shamela0011566,0845Maqrizi.Mawaciz,0845Maqrizi,610
206158637333,2,549,Shamela0011566-ara1.completed,422,613,Shamela0011566,0845Maqrizi.Mawaciz,0845Maqrizi,191
128849194453,2,549,Shamela0011566-ara1.completed,613,773,Shamela0011566,0845Maqrizi.Mawaciz,0845Maqrizi,160
206158534345,2,1935,Shamela0011566-ara1.completed,50,1581,Shamela0011566,0845Maqrizi.Mawaciz,0845Maqrizi,1531
249108239778,2,1839,Shamela0011566-ara1.completed,1199,1538,Shamela0011566,0845Maqrizi.Mawaciz,0845Maqrizi,339
506806246041,2,1160,Shamela0011566-ara1.completed,11,577,Shamela0011566,0845Maqrizi.Mawaciz,0845Maqrizi,566
34359826411,2,1160,Shamela0011566-ara1.completed,633,1386,Shamela0011566,0845Maqrizi.Mawaciz,0845Maqrizi,753
249108236404,2,1160,Shamela0011566-ara1.completed,1449,1832,Shamela0011566,0845Maqrizi.Mawaciz,0845Maqrizi,383
103079299590,2,1888,Shamela0011566-ara1.completed,1,298,Shamela0011566,0845Maqrizi.Mawaciz,0845Maqrizi,297
42949842141,2,231,Shamela0011566-ara1.completed,1,127,Shamela0011566,0845Maqrizi.Mawaciz,0845Maqrizi,126
42949842140,2,231,Shamela0011566-ara1.completed,324,603,Shamela0011566,0845Maqrizi.Mawaciz,0845Maqrizi,279
32167,2,667,Shamela0011566-ara1.completed,955,1469,Shamela0011566,0845Maqrizi.Mawaciz,0845Maqrizi,514
274877934539,2,523,Shamela0011566-ara1.completed,1272,1512,Shamela0011566,0845Maqrizi.Mawaciz,0845Maqrizi,240
601295505863,2,602,Shamela0011566-ara1.completed,111,1621,Shamela0011566,0845Maqrizi.Mawaciz,0845Maqrizi,1510
438086837649,2,1143,Shamela0011566-ara1.completed,555,1051,Shamela0011566,0845Maqrizi.Mawaciz,0845Maqrizi,496
111669296936,2,1872,Shamela0011566-ara1.completed,349,576,Shamela0011566,0845Maqrizi.Mawaciz,0845Maqrizi,227
128849065824,2,1872,Shamela0011566-ara1.completed,285,550,Shamela0011566,0845Maqrizi.Mawaciz,0845Maqrizi,265
506806310778,2,1875,Shamela0011566-ara1.completed,1,698,Shamela0011566,0845Maqrizi.Mawaciz,0845Maqrizi,697
317827722647,2,1904,Shamela0011566-ara1.completed,1369,1529,Shamela0011566,0845Maqrizi.Mawaciz,0845Maqrizi,160
309237838159,2,1499,Shamela0011566-ara1.completed,1344,1548,Shamela0011566,0845Maqrizi.Mawaciz,0845Maqrizi,204
51539761477,2,1036,Shamela0011566-ara1.completed,249,454,Shamela0011566,0845Maqrizi.Mawaciz,0845Maqrizi,205
77309481515,2,367,Shamela0011566-ara1.completed,490,1132,Shamela0011566,0845Maqrizi.Mawaciz,0845Maqrizi,642
77309489842,2,650,Shamela0011566-ara1.completed,780,1457,Shamela0011566,0845Maqrizi.Mawaciz,0845Maqrizi,677
34359888570,2,650,Shamela0011566-ara1.completed,1,780,Shamela0011566,0845Maqrizi.Mawaciz,0845Maqrizi,779
103079284223,2,535,Shamela0011566-ara1.completed,595,747,Shamela0011566,0845Maqrizi.Mawaciz,0845Maqrizi,152
223338423135,2,1871,Shamela0011566-ara1.completed,4,203,Shamela0011566,0845Maqrizi.Mawaciz,0845Maqrizi,199
206158453466,2,1871,Shamela0011566-ara1.completed,714,1109,Shamela0011566,0845Maqrizi.Mawaciz,0845Maqrizi,395
111669296937,2,1871,Shamela0011566-ara1.completed,789,1092,Shamela0011566,0845Maqrizi.Mawaciz,0845Maqrizi,303
223338423132,2,1871,Shamela0011566-ara1.completed,84,441,Shamela0011566,0845Maqrizi.Mawaciz,0845Maqrizi,357
128849065823,2,1871,Shamela0011566-ara1.completed,232,506,Shamela0011566,0845Maqrizi.Mawaciz,0845Maqrizi,274
231928351964,2,599,Shamela0011566-ara1.completed,1,290,Shamela0011566,0845Maqrizi.Mawaciz,0845Maqrizi,289
231928351965,2,599,Shamela0011566-ara1.completed,144,434,Shamela0011566,0845Maqrizi.Mawaciz,0845Maqrizi,290
8589985925,2,599,Shamela0011566-ara1.completed,290,1625,Shamela0011566,0845Maqrizi.Mawaciz,0845Maqrizi,1335
17179894110,2,968,Shamela0011566-ara1.completed,12,323,Shamela0011566,0845Maqrizi.Mawaciz,0845Maqrizi,311
326417638466,2,510,Shamela0011566-ara1.completed,315,1644,Shamela0011566,0845Maqrizi.Mawaciz,0845Maqrizi,1329
249108105650,2,1709,Shamela0011566-ara1.completed,721,1190,Shamela0011566,0845Maqrizi.Mawaciz,0845Maqrizi,469
93758,2,1709,Shamela0011566-ara1.completed,1,1190,Shamela0011566,0845Maqrizi.Mawaciz,0845Maqrizi,1189
412316994837,2,658,Shamela0011566-ara1.completed,601,807,Shamela0011566,0845Maqrizi.Mawaciz,0845Maqrizi,206
429496868666,2,205,Shamela0011566-ara1.completed,498,1246,Shamela0011566,0845Maqrizi.Mawaciz,0845Maqrizi,748
506806184610,2,205,Shamela0011566-ara1.completed,167,506,Shamela0011566,0845Maqrizi.Mawaciz,0845Maqrizi,339
51539767846,2,2122,Shamela0011566-ara1.completed,1,1413,Shamela0011566,0845Maqrizi.Mawaciz,0845Maqrizi,1412
60129544726,2,1155,Shamela0011566-ara1.completed,393,1373,Shamela0011566,0845Maqrizi.Mawaciz,0845Maqrizi,980
360777427964,2,1155,Shamela0011566-ara1.completed,126,858,Shamela0011566,0845Maqrizi.Mawaciz,0845Maqrizi,732
168264,2,2017,Shamela0011566-ara1.completed,1,368,Shamela0011566,0845Maqrizi.Mawaciz,0845Maqrizi,367
506806202802,2,1518,Shamela0011566-ara1.completed,589,808,Shamela0011566,0845Maqrizi.Mawaciz,0845Maqrizi,219
558345840210,2,1518,Shamela0011566-ara1.completed,1151,1304,Shamela0011566,0845Maqrizi.Mawaciz,0845Maqrizi,153
472446623049,2,1518,Shamela0011566-ara1.completed,144,556,Shamela0011566,0845Maqrizi.Mawaciz,0845Maqrizi,412
197568520244,2,13,Shamela0011566-ara1.completed,746,1758,Shamela0011566,0845Maqrizi.Mawaciz,0845Maqrizi,1012
68719670407,2,1722,Shamela0011566-ara1.completed,1262,1502,Shamela0011566,0845Maqrizi.Mawaciz,0845Maqrizi,240
335007449474,2,1722,Shamela0011566-ara1.completed,29,476,Shamela0011566,0845Maqrizi.Mawaciz,0845Maqrizi,447
154314,2,1586,Shamela0011566-ara1.completed,1041,1633,Shamela0011566,0845Maqrizi.Mawaciz,0845Maqrizi,592
249108164769,2,1748,Shamela0011566-ara1.completed,437,586,Shamela0011566,0845Maqrizi.Mawaciz,0845Maqrizi,149
249108164767,2,1748,Shamela0011566-ara1.completed,1,437,Shamela0011566,0845Maqrizi.Mawaciz,0845Maqrizi,436
128849022709,2,738,Shamela0011566-ara1.completed,762,1429,Shamela0011566,0845Maqrizi.Mawaciz,0845Maqrizi,667
386547174840,2,1990,Shamela0011566-ara1.completed,24,582,Shamela0011566,0845Maqrizi.Mawaciz,0845Maqrizi,558
180388638712,2,18,Shamela0011566-ara1.completed,1137,1580,Shamela0011566,0845Maqrizi.Mawaciz,0845Maqrizi,443
249108107924,2,18,Shamela0011566-ara1.completed,1,1137,Shamela0011566,0845Maqrizi.Mawaciz,0845Maqrizi,1136
188978641312,2,1532,Shamela0011566-ara1.completed,1221,1601,Shamela0011566,0845Maqrizi.Mawaciz,0845Maqrizi,380
17180033706,2,1532,Shamela0011566-ara1.completed,454,1081,Shamela0011566,0845Maqrizi.Mawaciz,0845Maqrizi,627
34359917842,2,1519,Shamela0011566-ara1.completed,262,1515,Shamela0011566,0845Maqrizi.Mawaciz,0845Maqrizi,1253
137439007815,2,971,Shamela0011566-ara1.completed,495,1233,Shamela0011566,0845Maqrizi.Mawaciz,0845Maqrizi,738
34359804759,2,971,Shamela0011566-ara1.completed,1,1124,Shamela0011566,0845Maqrizi.Mawaciz,0845Maqrizi,1123
34359804765,3,971,Shamela0011566-ara1.completed,67,786,Shamela0011566,0845Maqrizi.Mawaciz,0845Maqrizi,719
103079369518,2,1682,Shamela0011566-ara1.completed,1144,1370,Shamela0011566,0845Maqrizi.Mawaciz,0845Maqrizi,226
257698041770,2,1098,Shamela0011566-ara1.completed,1471,1599,Shamela0011566,0845Maqrizi.Mawaciz,0845Maqrizi,128
85899397426,2,807,Shamela0011566-ara1.completed,299,838,Shamela0011566,0845Maqrizi.Mawaciz,0845Maqrizi,539
85899397428,2,807,Shamela0011566-ara1.completed,844,1215,Shamela0011566,0845Maqrizi.Mawaciz,0845Maqrizi,371
317827624824,2,807,Shamela0011566-ara1.completed,1,262,Shamela0011566,0845Maqrizi.Mawaciz,0845Maqrizi,261
231928265324,2,1169,Shamela0011566-ara1.completed,241,684,Shamela0011566,0845Maqrizi.Mawaciz,0845Maqrizi,443
163208937547,2,757,Shamela0011566-ara1.completed,1173,1523,Shamela0011566,0845Maqrizi.Mawaciz,0845Maqrizi,350
618475498999,2,1293,Shamela0011566-ara1.completed,725,1308,Shamela0011566,0845Maqrizi.Mawaciz,0845Maqrizi,583
154618958642,2,589,Shamela0011566-ara1.completed,1,1316,Shamela0011566,0845Maqrizi.Mawaciz,0845Maqrizi,1315
154618958645,2,589,Shamela0011566-ara1.completed,1048,1490,Shamela0011566,0845Maqrizi.Mawaciz,0845Maqrizi,442
137439032998,2,589,Shamela0011566-ara1.completed,420,953,Shamela0011566,0845Maqrizi.Mawaciz,0845Maqrizi,533
154618958647,2,589,Shamela0011566-ara1.completed,1316,1490,Shamela0011566,0845Maqrizi.Mawaciz,0845Maqrizi,174
128849059856,2,2221,Shamela0011566-ara1.completed,1,299,Shamela0011566,0845Maqrizi.Mawaciz,0845Maqrizi,298
85899546401,2,1691,Shamela0011566-ara1.completed,44,483,Shamela0011566,0845Maqrizi.Mawaciz,0845Maqrizi,439
128849094639,4,676,Shamela0011566-ara1.completed,854,1297,Shamela0011566,0845Maqrizi.Mawaciz,0845Maqrizi,443
386547242171,2,1659,Shamela0011566-ara1.completed,1039,1214,Shamela0011566,0845Maqrizi.Mawaciz,0845Maqrizi,175
386547264782,2,578,Shamela0011566-ara1.completed,1,625,Shamela0011566,0845Maqrizi.Mawaciz,0845Maqrizi,624
146029078128,2,578,Shamela0011566-ara1.completed,625,1601,Shamela0011566,0845Maqrizi.Mawaciz,0845Maqrizi,976
420906899284,2,2188,Shamela0011566-ara1.completed,14,1199,Shamela0011566,0845Maqrizi.Mawaciz,0845Maqrizi,1185
335007506882,2,721,Shamela0011566-ara1.completed,751,1536,Shamela0011566,0845Maqrizi.Mawaciz,0845Maqrizi,785
249108194792,2,721,Shamela0011566-ara1.completed,29,751,Shamela0011566,0845Maqrizi.Mawaciz,0845Maqrizi,722
352187524281,2,1106,Shamela0011566-ara1.completed,562,1516,Shamela0011566,0845Maqrizi.Mawaciz,0845Maqrizi,954
283467849130,2,2101,Shamela0011566-ara1.completed,1272,1485,Shamela0011566,0845Maqrizi.Mawaciz,0845Maqrizi,213
83035,3,2101,Shamela0011566-ara1.completed,29,449,Shamela0011566,0845Maqrizi.Mawaciz,0845Maqrizi,420
523986177467,2,1747,Shamela0011566-ara1.completed,1402,1644,Shamela0011566,0845Maqrizi.Mawaciz,0845Maqrizi,242
68719596653,2,1747,Shamela0011566-ara1.completed,462,1402,Shamela0011566,0845Maqrizi.Mawaciz,0845Maqrizi,940
188978720101,2,1747,Shamela0011566-ara1.completed,1,1205,Shamela0011566,0845Maqrizi.Mawaciz,0845Maqrizi,1204
446676619977,2,1747,Shamela0011566-ara1.completed,1033,1554,Shamela0011566,0845Maqrizi.Mawaciz,0845Maqrizi,521
335007550411,2,6,Shamela0011566-ara1.completed,179,333,Shamela0011566,0845Maqrizi.Mawaciz,0845Maqrizi,154
498216392939,2,1907,Shamela0011566-ara1.completed,1079,1273,Shamela0011566,0845Maqrizi.Mawaciz,0845Maqrizi,194
463856537424,2,192,Shamela0011566-ara1.completed,179,653,Shamela0011566,0845Maqrizi.Mawaciz,0845Maqrizi,474
77309526181,2,192,Shamela0011566-ara1.completed,879,1208,Shamela0011566,0845Maqrizi.Mawaciz,0845Maqrizi,329
463856537423,2,192,Shamela0011566-ara1.completed,669,812,Shamela0011566,0845Maqrizi.Mawaciz,0845Maqrizi,143
266288059115,2,2072,Shamela0011566-ara1.completed,695,1287,Shamela0011566,0845Maqrizi.Mawaciz,0845Maqrizi,592
124986,2,2072,Shamela0011566-ara1.completed,798,1287,Shamela0011566,0845Maqrizi.Mawaciz,0845Maqrizi,489
8590080988,2,530,Shamela0011566-ara1.completed,529,1582,Shamela0011566,0845Maqrizi.Mawaciz,0845Maqrizi,1053
111669197346,2,1858,Shamela0011566-ara1.completed,415,954,Shamela0011566,0845Maqrizi.Mawaciz,0845Maqrizi,539
266288107790,2,63,Shamela0011566-ara1.completed,1333,1511,Shamela0011566,0845Maqrizi.Mawaciz,0845Maqrizi,178
85899373473,2,2195,Shamela0011566-ara1.completed,1,321,Shamela0011566,0845Maqrizi.Mawaciz,0845Maqrizi,320
85899373475,2,2195,Shamela0011566-ara1.completed,875,1062,Shamela0011566,0845Maqrizi.Mawaciz,0845Maqrizi,187
395137051086,2,2073,Shamela0011566-ara1.completed,1314,1684,Shamela0011566,0845Maqrizi.Mawaciz,0845Maqrizi,370
317827623524,2,1554,Shamela0011566-ara1.completed,642,1628,Shamela0011566,0845Maqrizi.Mawaciz,0845Maqrizi,986
360777414885,2,1397,Shamela0011566-ara1.completed,174,403,Shamela0011566,0845Maqrizi.Mawaciz,0845Maqrizi,229
635655264034,2,927,Shamela0011566-ara1.completed,117,354,Shamela0011566,0845Maqrizi.Mawaciz,0845Maqrizi,237
85899546400,2,1694,Shamela0011566-ara1.completed,44,420,Shamela0011566,0845Maqrizi.Mawaciz,0845Maqrizi,376
335007452351,2,2202,Shamela0011566-ara1.completed,989,1429,Shamela0011566,0845Maqrizi.Mawaciz,0845Maqrizi,440
128849194631,2,862,Shamela0011566-ara1.completed,650,921,Shamela0011566,0845Maqrizi.Mawaciz,0845Maqrizi,271
128849230309,2,862,Shamela0011566-ara1.completed,810,1339,Shamela0011566,0845Maqrizi.Mawaciz,0845Maqrizi,529
60129579692,2,1862,Shamela0011566-ara1.completed,166,389,Shamela0011566,0845Maqrizi.Mawaciz,0845Maqrizi,223
77309545494,2,576,Shamela0011566-ara1.completed,6,770,Shamela0011566,0845Maqrizi.Mawaciz,0845Maqrizi,764
77309545493,2,576,Shamela0011566-ara1.completed,770,1616,Shamela0011566,0845Maqrizi.Mawaciz,0845Maqrizi,846
154618918057,2,1973,Shamela0011566-ara1.completed,1,117,Shamela0011566,0845Maqrizi.Mawaciz,0845Maqrizi,116
128849211964,2,946,Shamela0011566-ara1.completed,482,847,Shamela0011566,0845Maqrizi.Mawaciz,0845Maqrizi,365
34359739553,2,816,Shamela0011566-ara1.completed,1,487,Shamela0011566,0845Maqrizi.Mawaciz,0845Maqrizi,486
206158478877,2,230,Shamela0011566-ara1.completed,1075,1539,Shamela0011566,0845Maqrizi.Mawaciz,0845Maqrizi,464
128849195502,2,1427,Shamela0011566-ara1.completed,101,982,Shamela0011566,0845Maqrizi.Mawaciz,0845Maqrizi,881
128849195501,2,1427,Shamela0011566-ara1.completed,660,1637,Shamela0011566,0845Maqrizi.Mawaciz,0845Maqrizi,977
42949738876,2,1996,Shamela0011566-ara1.completed,1,368,Shamela0011566,0845Maqrizi.Mawaciz,0845Maqrizi,367
463856555189,2,460,Shamela0011566-ara1.completed,1,293,Shamela0011566,0845Maqrizi.Mawaciz,0845Maqrizi,292
463856555186,2,460,Shamela0011566-ara1.completed,1022,1279,Shamela0011566,0845Maqrizi.Mawaciz,0845Maqrizi,257
231928380912,2,521,Shamela0011566-ara1.completed,1032,1223,Shamela0011566,0845Maqrizi.Mawaciz,0845Maqrizi,191
51539761475,2,1120,Shamela0011566-ara1.completed,1038,1539,Shamela0011566,0845Maqrizi.Mawaciz,0845Maqrizi,501
51539761479,3,1120,Shamela0011566-ara1.completed,1161,1633,Shamela0011566,0845Maqrizi.Mawaciz,0845Maqrizi,472
137439117366,2,592,Shamela0011566-ara1.completed,1,142,Shamela0011566,0845Maqrizi.Mawaciz,0845Maqrizi,141
103079372611,2,2191,Shamela0011566-ara1.completed,55,1656,Shamela0011566,0845Maqrizi.Mawaciz,0845Maqrizi,1601
17179917873,2,70,Shamela0011566-ara1.completed,1,332,Shamela0011566,0845Maqrizi.Mawaciz,0845Maqrizi,331
163208761183,2,796,Shamela0011566-ara1.completed,1,640,Shamela0011566,0845Maqrizi.Mawaciz,0845Maqrizi,639
103079217153,2,796,Shamela0011566-ara1.completed,555,753,Shamela0011566,0845Maqrizi.Mawaciz,0845Maqrizi,198
103079217154,2,796,Shamela0011566-ara1.completed,218,406,Shamela0011566,0845Maqrizi.Mawaciz,0845Maqrizi,188
223338455691,2,1947,Shamela0011566-ara1.completed,226,630,Shamela0011566,0845Maqrizi.Mawaciz,0845Maqrizi,404
223338455690,2,1947,Shamela0011566-ara1.completed,226,630,Shamela0011566,0845Maqrizi.Mawaciz,0845Maqrizi,404
77309431149,2,1665,Shamela0011566-ara1.completed,223,365,Shamela0011566,0845Maqrizi.Mawaciz,0845Maqrizi,142
77309431148,2,1665,Shamela0011566-ara1.completed,291,623,Shamela0011566,0845Maqrizi.Mawaciz,0845Maqrizi,332
335007449475,2,1721,Shamela0011566-ara1.completed,1,295,Shamela0011566,0845Maqrizi.Mawaciz,0845Maqrizi,294
240518250795,2,814,Shamela0011566-ara1.completed,1233,1474,Shamela0011566,0845Maqrizi.Mawaciz,0845Maqrizi,241
240518250796,2,814,Shamela0011566-ara1.completed,545,770,Shamela0011566,0845Maqrizi.Mawaciz,0845Maqrizi,225
111669190333,2,2097,Shamela0011566-ara1.completed,1,134,Shamela0011566,0845Maqrizi.Mawaciz,0845Maqrizi,133
180388795936,3,2097,Shamela0011566-ara1.completed,363,815,Shamela0011566,0845Maqrizi.Mawaciz,0845Maqrizi,452
42949886296,2,1091,Shamela0011566-ara1.completed,1,853,Shamela0011566,0845Maqrizi.Mawaciz,0845Maqrizi,852
42949886297,3,1091,Shamela0011566-ara1.completed,853,1559,Shamela0011566,0845Maqrizi.Mawaciz,0845Maqrizi,706
34359887856,2,692,Shamela0011566-ara1.completed,720,1228,Shamela0011566,0845Maqrizi.Mawaciz,0845Maqrizi,508
429496803468,2,1889,Shamela0011566-ara1.completed,638,1050,Shamela0011566,0845Maqrizi.Mawaciz,0845Maqrizi,412
137438968377,2,28,Shamela0011566-ara1.completed,1,1011,Shamela0011566,0845Maqrizi.Mawaciz,0845Maqrizi,1010
223338330655,2,28,Shamela0011566-ara1.completed,1011,1752,Shamela0011566,0845Maqrizi.Mawaciz,0845Maqrizi,741
214748390911,2,28,Shamela0011566-ara1.completed,981,1363,Shamela0011566,0845Maqrizi.Mawaciz,0845Maqrizi,382
180388678271,2,28,Shamela0011566-ara1.completed,475,1056,Shamela0011566,0845Maqrizi.Mawaciz,0845Maqrizi,581
128849156516,2,1724,Shamela0011566-ara1.completed,4,1264,Shamela0011566,0845Maqrizi.Mawaciz,0845Maqrizi,1260
352187366645,2,2031,Shamela0011566-ara1.completed,901,1665,Shamela0011566,0845Maqrizi.Mawaciz,0845Maqrizi,764
103079273390,2,1832,Shamela0011566-ara1.completed,484,1457,Shamela0011566,0845Maqrizi.Mawaciz,0845Maqrizi,973
592705580044,2,2074,Shamela0011566-ara1.completed,474,980,Shamela0011566,0845Maqrizi.Mawaciz,0845Maqrizi,506
438086814300,2,94,Shamela0011566-ara1.completed,1286,1604,Shamela0011566,0845Maqrizi.Mawaciz,0845Maqrizi,318
231928435538,2,2185,Shamela0011566-ara1.completed,1,173,Shamela0011566,0845Maqrizi.Mawaciz,0845Maqrizi,172
223338308280,2,2185,Shamela0011566-ara1.completed,387,520,Shamela0011566,0845Maqrizi.Mawaciz,0845Maqrizi,133
51539773388,3,1733,Shamela0011566-ara1.completed,97,765,Shamela0011566,0845Maqrizi.Mawaciz,0845Maqrizi,668
56702,2,1733,Shamela0011566-ara1.completed,1,196,Shamela0011566,0845Maqrizi.Mawaciz,0845Maqrizi,195
51539773386,2,1733,Shamela0011566-ara1.completed,15,1547,Shamela0011566,0845Maqrizi.Mawaciz,0845Maqrizi,1532
51539773390,3,1733,Shamela0011566-ara1.completed,765,1547,Shamela0011566,0845Maqrizi.Mawaciz,0845Maqrizi,782
566935874662,2,737,Shamela0011566-ara1.completed,1300,1564,Shamela0011566,0845Maqrizi.Mawaciz,0845Maqrizi,264
128849169396,2,477,Shamela0011566-ara1.completed,358,1433,Shamela0011566,0845Maqrizi.Mawaciz,0845Maqrizi,1075
8590122951,2,68,Shamela0011566-ara1.completed,1043,1569,Shamela0011566,0845Maqrizi.Mawaciz,0845Maqrizi,526
34359888571,2,649,Shamela0011566-ara1.completed,832,1536,Shamela0011566,0845Maqrizi.Mawaciz,0845Maqrizi,704
309237713133,3,649,Shamela0011566-ara1.completed,309,621,Shamela0011566,0845Maqrizi.Mawaciz,0845Maqrizi,312
386547235185,2,649,Shamela0011566-ara1.completed,1,832,Shamela0011566,0845Maqrizi.Mawaciz,0845Maqrizi,831
386547235188,3,649,Shamela0011566-ara1.completed,621,879,Shamela0011566,0845Maqrizi.Mawaciz,0845Maqrizi,258
42949780222,2,1471,Shamela0011566-ara1.completed,700,1012,Shamela0011566,0845Maqrizi.Mawaciz,0845Maqrizi,312
171798807104,3,1865,Shamela0011566-ara1.completed,1131,1509,Shamela0011566,0845Maqrizi.Mawaciz,0845Maqrizi,378
171798807103,2,1865,Shamela0011566-ara1.completed,704,1530,Shamela0011566,0845Maqrizi.Mawaciz,0845Maqrizi,826
369367356625,2,1865,Shamela0011566-ara1.completed,882,1091,Shamela0011566,0845Maqrizi.Mawaciz,0845Maqrizi,209
403727097441,2,1295,Shamela0011566-ara1.completed,275,617,Shamela0011566,0845Maqrizi.Mawaciz,0845Maqrizi,342
120259184908,2,1295,Shamela0011566-ara1.completed,785,993,Shamela0011566,0845Maqrizi.Mawaciz,0845Maqrizi,208
257698183083,2,1742,Shamela0011566-ara1.completed,1,184,Shamela0011566,0845Maqrizi.Mawaciz,0845Maqrizi,183
94489350485,2,1742,Shamela0011566-ara1.completed,184,1604,Shamela0011566,0845Maqrizi.Mawaciz,0845Maqrizi,1420
138781,2,1669,Shamela0011566-ara1.completed,153,341,Shamela0011566,0845Maqrizi.Mawaciz,0845Maqrizi,188
317827604236,2,799,Shamela0011566-ara1.completed,1119,1439,Shamela0011566,0845Maqrizi.Mawaciz,0845Maqrizi,320
326417570309,2,799,Shamela0011566-ara1.completed,905,1561,Shamela0011566,0845Maqrizi.Mawaciz,0845Maqrizi,656
584115700814,2,2198,Shamela0011566-ara1.completed,249,1632,Shamela0011566,0845Maqrizi.Mawaciz,0845Maqrizi,1383
128849021287,3,1894,Shamela0011566-ara1.completed,1,448,Shamela0011566,0845Maqrizi.Mawaciz,0845Maqrizi,447
206158453468,2,1894,Shamela0011566-ara1.completed,1434,1661,Shamela0011566,0845Maqrizi.Mawaciz,0845Maqrizi,227
326417569228,2,1894,Shamela0011566-ara1.completed,402,1135,Shamela0011566,0845Maqrizi.Mawaciz,0845Maqrizi,733
326417569227,2,1894,Shamela0011566-ara1.completed,1227,1439,Shamela0011566,0845Maqrizi.Mawaciz,0845Maqrizi,212
111669296933,2,1894,Shamela0011566-ara1.completed,675,1625,Shamela0011566,0845Maqrizi.Mawaciz,0845Maqrizi,950
34359757274,2,16,Shamela0011566-ara1.completed,690,1608,Shamela0011566,0845Maqrizi.Mawaciz,0845Maqrizi,918
506806153362,2,16,Shamela0011566-ara1.completed,1,690,Shamela0011566,0845Maqrizi.Mawaciz,0845Maqrizi,689
386547191763,2,1408,Shamela0011566-ara1.completed,894,1193,Shamela0011566,0845Maqrizi.Mawaciz,0845Maqrizi,299
197568687205,2,1408,Shamela0011566-ara1.completed,1077,1282,Shamela0011566,0845Maqrizi.Mawaciz,0845Maqrizi,205
326417655596,2,2037,Shamela0011566-ara1.completed,606,878,Shamela0011566,0845Maqrizi.Mawaciz,0845Maqrizi,272
300647860613,2,1403,Shamela0011566-ara1.completed,1,1117,Shamela0011566,0845Maqrizi.Mawaciz,0845Maqrizi,1116
300647860612,3,1403,Shamela0011566-ara1.completed,174,445,Shamela0011566,0845Maqrizi.Mawaciz,0845Maqrizi,271
377957228797,2,583,Shamela0011566-ara1.completed,1,531,Shamela0011566,0845Maqrizi.Mawaciz,0845Maqrizi,530
231928253179,2,583,Shamela0011566-ara1.completed,531,1680,Shamela0011566,0845Maqrizi.Mawaciz,0845Maqrizi,1149
111669211161,2,594,Shamela0011566-ara1.completed,1,1302,Shamela0011566,0845Maqrizi.Mawaciz,0845Maqrizi,1301
111669211162,3,594,Shamela0011566-ara1.completed,715,1418,Shamela0011566,0845Maqrizi.Mawaciz,0845Maqrizi,703
163208934742,3,594,Shamela0011566-ara1.completed,1302,1659,Shamela0011566,0845Maqrizi.Mawaciz,0845Maqrizi,357
94489451192,7,60,Shamela0011566-ara1.completed,1050,1238,Shamela0011566,0845Maqrizi.Mawaciz,0845Maqrizi,188
188978771651,2,1939,Shamela0011566-ara1.completed,392,578,Shamela0011566,0845Maqrizi.Mawaciz,0845Maqrizi,186
283468014069,2,653,Shamela0011566-ara1.completed,1,705,Shamela0011566,0845Maqrizi.Mawaciz,0845Maqrizi,704
146028968238,6,382,Shamela0011566-ara1.completed,5,652,Shamela0011566,0845Maqrizi.Mawaciz,0845Maqrizi,647
85899448019,2,71,Shamela0011566-ara1.completed,891,1349,Shamela0011566,0845Maqrizi.Mawaciz,0845Maqrizi,458
455266595259,2,755,Shamela0011566-ara1.completed,384,788,Shamela0011566,0845Maqrizi.Mawaciz,0845Maqrizi,404
274877911569,2,954,Shamela0011566-ara1.completed,595,1317,Shamela0011566,0845Maqrizi.Mawaciz,0845Maqrizi,722
352187538713,2,1617,Shamela0011566-ara1.completed,345,717,Shamela0011566,0845Maqrizi.Mawaciz,0845Maqrizi,372
257698128629,3,1735,Shamela0011566-ara1.completed,808,1051,Shamela0011566,0845Maqrizi.Mawaciz,0845Maqrizi,243
257698128626,2,1735,Shamela0011566-ara1.completed,5,1524,Shamela0011566,0845Maqrizi.Mawaciz,0845Maqrizi,1519
120259209583,3,1735,Shamela0011566-ara1.completed,1379,1572,Shamela0011566,0845Maqrizi.Mawaciz,0845Maqrizi,193
223338488986,3,1735,Shamela0011566-ara1.completed,91,787,Shamela0011566,0845Maqrizi.Mawaciz,0845Maqrizi,696
257698128628,3,1735,Shamela0011566-ara1.completed,1051,1572,Shamela0011566,0845Maqrizi.Mawaciz,0845Maqrizi,521
171798746338,2,1917,Shamela0011566-ara1.completed,1081,1599,Shamela0011566,0845Maqrizi.Mawaciz,0845Maqrizi,518
17180074828,2,913,Shamela0011566-ara1.completed,494,1659,Shamela0011566,0845Maqrizi.Mawaciz,0845Maqrizi,1165
163208817325,2,859,Shamela0011566-ara1.completed,252,897,Shamela0011566,0845Maqrizi.Mawaciz,0845Maqrizi,645
168261,2,2016,Shamela0011566-ara1.completed,1002,1690,Shamela0011566,0845Maqrizi.Mawaciz,0845Maqrizi,688
326417640915,2,565,Shamela0011566-ara1.completed,118,1070,Shamela0011566,0845Maqrizi.Mawaciz,0845Maqrizi,952
188978768212,2,885,Shamela0011566-ara1.completed,1201,1462,Shamela0011566,0845Maqrizi.Mawaciz,0845Maqrizi,261
369367188858,3,86,Shamela0011566-ara1.completed,957,1532,Shamela0011566,0845Maqrizi.Mawaciz,0845Maqrizi,575
386547130485,2,1835,Shamela0011566-ara1.completed,1,219,Shamela0011566,0845Maqrizi.Mawaciz,0845Maqrizi,218
68719533994,2,1787,Shamela0011566-ara1.completed,423,959,Shamela0011566,0845Maqrizi.Mawaciz,0845Maqrizi,536
103079253761,3,574,Shamela0011566-ara1.completed,89,256,Shamela0011566,0845Maqrizi.Mawaciz,0845Maqrizi,167
103079253760,2,574,Shamela0011566-ara1.completed,720,988,Shamela0011566,0845Maqrizi.Mawaciz,0845Maqrizi,268
103079253758,2,574,Shamela0011566-ara1.completed,81,748,Shamela0011566,0845Maqrizi.Mawaciz,0845Maqrizi,667
103079253759,2,574,Shamela0011566-ara1.completed,1038,1564,Shamela0011566,0845Maqrizi.Mawaciz,0845Maqrizi,526
7637,3,1137,Shamela0011566-ara1.completed,173,351,Shamela0011566,0845Maqrizi.Mawaciz,0845Maqrizi,178
146028970704,2,2197,Shamela0011566-ara1.completed,1,1204,Shamela0011566,0845Maqrizi.Mawaciz,0845Maqrizi,1203
300647755044,2,2197,Shamela0011566-ara1.completed,1204,1564,Shamela0011566,0845Maqrizi.Mawaciz,0845Maqrizi,360
94489313234,2,694,Shamela0011566-ara1.completed,254,675,Shamela0011566,0845Maqrizi.Mawaciz,0845Maqrizi,421
85899441279,2,1779,Shamela0011566-ara1.completed,1,475,Shamela0011566,0845Maqrizi.Mawaciz,0845Maqrizi,474
25769895358,2,1823,Shamela0011566-ara1.completed,1213,1552,Shamela0011566,0845Maqrizi.Mawaciz,0845Maqrizi,339
292057839316,2,1651,Shamela0011566-ara1.completed,803,1560,Shamela0011566,0845Maqrizi.Mawaciz,0845Maqrizi,757
146029052637,4,601,Shamela0011566-ara1.completed,287,711,Shamela0011566,0845Maqrizi.Mawaciz,0845Maqrizi,424
146029052636,4,601,Shamela0011566-ara1.completed,1,462,Shamela0011566,0845Maqrizi.Mawaciz,0845Maqrizi,461
8589995106,2,1641,Shamela0011566-ara1.completed,248,670,Shamela0011566,0845Maqrizi.Mawaciz,0845Maqrizi,422
249108236779,2,1726,Shamela0011566-ara1.completed,1,362,Shamela0011566,0845Maqrizi.Mawaciz,0845Maqrizi,361
498216353305,2,342,Shamela0011566-ara1.completed,306,1571,Shamela0011566,0845Maqrizi.Mawaciz,0845Maqrizi,1265
42949886297,3,1528,Shamela0011566-ara1.completed,164,991,Shamela0011566,0845Maqrizi.Mawaciz,0845Maqrizi,827
223338519124,2,1936,Shamela0011566-ara1.completed,56,1582,Shamela0011566,0845Maqrizi.Mawaciz,0845Maqrizi,1526
25769852344,2,52,Shamela0011566-ara1.completed,141,1030,Shamela0011566,0845Maqrizi.Mawaciz,0845Maqrizi,889
266288156174,2,1573,Shamela0011566-ara1.completed,313,562,Shamela0011566,0845Maqrizi.Mawaciz,0845Maqrizi,249
335007648479,2,1134,Shamela0011566-ara1.completed,447,926,Shamela0011566,0845Maqrizi.Mawaciz,0845Maqrizi,479
34359872557,2,1134,Shamela0011566-ara1.completed,253,993,Shamela0011566,0845Maqrizi.Mawaciz,0845Maqrizi,740
77309531373,4,965,Shamela0011566-ara1.completed,1130,1529,Shamela0011566,0845Maqrizi.Mawaciz,0845Maqrizi,399
77309531370,3,965,Shamela0011566-ara1.completed,877,1559,Shamela0011566,0845Maqrizi.Mawaciz,0845Maqrizi,682
377957296709,2,965,Shamela0011566-ara1.completed,290,922,Shamela0011566,0845Maqrizi.Mawaciz,0845Maqrizi,632
377957296707,2,965,Shamela0011566-ara1.completed,566,877,Shamela0011566,0845Maqrizi.Mawaciz,0845Maqrizi,311
377957296708,2,965,Shamela0011566-ara1.completed,1,948,Shamela0011566,0845Maqrizi.Mawaciz,0845Maqrizi,947
283467880367,2,965,Shamela0011566-ara1.completed,1,379,Shamela0011566,0845Maqrizi.Mawaciz,0845Maqrizi,378
77309503329,2,1035,Shamela0011566-ara1.completed,208,1640,Shamela0011566,0845Maqrizi.Mawaciz,0845Maqrizi,1432
60129766345,2,2099,Shamela0011566-ara1.completed,1,158,Shamela0011566,0845Maqrizi.Mawaciz,0845Maqrizi,157
42949699631,2,2131,Shamela0011566-ara1.completed,671,1416,Shamela0011566,0845Maqrizi.Mawaciz,0845Maqrizi,745
34359891301,2,804,Shamela0011566-ara1.completed,355,1125,Shamela0011566,0845Maqrizi.Mawaciz,0845Maqrizi,770
34359891302,2,804,Shamela0011566-ara1.completed,1125,1598,Shamela0011566,0845Maqrizi.Mawaciz,0845Maqrizi,473
223338365565,2,1402,Shamela0011566-ara1.completed,1450,1612,Shamela0011566,0845Maqrizi.Mawaciz,0845Maqrizi,162
249108236403,2,1161,Shamela0011566-ara1.completed,1,400,Shamela0011566,0845Maqrizi.Mawaciz,0845Maqrizi,399
137439137484,2,734,Shamela0011566-ara1.completed,446,1527,Shamela0011566,0845Maqrizi.Mawaciz,0845Maqrizi,1081
42949711086,2,734,Shamela0011566-ara1.completed,1122,1454,Shamela0011566,0845Maqrizi.Mawaciz,0845Maqrizi,332
197568588307,4,596,Shamela0011566-ara1.completed,1,218,Shamela0011566,0845Maqrizi.Mawaciz,0845Maqrizi,217
197568588305,2,596,Shamela0011566-ara1.completed,1255,1675,Shamela0011566,0845Maqrizi.Mawaciz,0845Maqrizi,420
197568588303,2,596,Shamela0011566-ara1.completed,1,1255,Shamela0011566,0845Maqrizi.Mawaciz,0845Maqrizi,1254
197568588304,4,596,Shamela0011566-ara1.completed,1,744,Shamela0011566,0845Maqrizi.Mawaciz,0845Maqrizi,743
197568588306,3,596,Shamela0011566-ara1.completed,369,744,Shamela0011566,0845Maqrizi.Mawaciz,0845Maqrizi,375
34359947049,2,449,Shamela0011566-ara1.completed,1,404,Shamela0011566,0845Maqrizi.Mawaciz,0845Maqrizi,403
63827,3,1152,Shamela0011566-ara1.completed,1356,1625,Shamela0011566,0845Maqrizi.Mawaciz,0845Maqrizi,269
352187368148,2,387,Shamela0011566-ara1.completed,1,622,Shamela0011566,0845Maqrizi.Mawaciz,0845Maqrizi,621
386547245886,2,250,Shamela0011566-ara1.completed,1035,1291,Shamela0011566,0845Maqrizi.Mawaciz,0845Maqrizi,256
240518290896,2,630,Shamela0011566-ara1.completed,1,603,Shamela0011566,0845Maqrizi.Mawaciz,0845Maqrizi,602
103079318985,2,1798,Shamela0011566-ara1.completed,1168,1429,Shamela0011566,0845Maqrizi.Mawaciz,0845Maqrizi,261
120259249636,2,2094,Shamela0011566-ara1.completed,21,399,Shamela0011566,0845Maqrizi.Mawaciz,0845Maqrizi,378
85899470562,2,1738,Shamela0011566-ara1.completed,1231,1578,Shamela0011566,0845Maqrizi.Mawaciz,0845Maqrizi,347
94489449020,2,1738,Shamela0011566-ara1.completed,707,999,Shamela0011566,0845Maqrizi.Mawaciz,0845Maqrizi,292
85899412458,2,1738,Shamela0011566-ara1.completed,1,1231,Shamela0011566,0845Maqrizi.Mawaciz,0845Maqrizi,1230
85899412459,5,1738,Shamela0011566-ara1.completed,445,925,Shamela0011566,0845Maqrizi.Mawaciz,0845Maqrizi,480
214748514992,3,121,Shamela0010710-ara1,604,825,Shamela0010710,0845Maqrizi.Rasail,0845Maqrizi,221
93758,2,45,Shamela0009226-ara1,500,1591,Shamela0009226,0845Maqrizi.Bayan,0845Maqrizi,1091
292057889028,2,66,Shamela0009226-ara1,288,605,Shamela0009226,0845Maqrizi.Bayan,0845Maqrizi,317
100166,2,50,Shamela0009226-ara1,687,841,Shamela0009226,0845Maqrizi.Bayan,0845Maqrizi,154
249108105650,2,47,Shamela0009226-ara1,1,471,Shamela0009226,0845Maqrizi.Bayan,0845Maqrizi,470
463856555186,2,44,Shamela0009226-ara1,870,1157,Shamela0009226,0845Maqrizi.Bayan,0845Maqrizi,287
146028995136,2,69,Shamela0009226-ara1,64,210,Shamela0009226,0845Maqrizi.Bayan,0845Maqrizi,146
283467883786,2,42,Shamela0009226-ara1,145,342,Shamela0009226,0845Maqrizi.Bayan,0845Maqrizi,197
335007575694,4,1,Shamela0010830-ara1,715,1046,Shamela0010830,0845Maqrizi.DuSari,0845Maqrizi,331
34359929872,5,74,Kraken210223142017-ara1,758,1372,Kraken210223142017,0845Maqrizi.IghathaUmma,0845Maqrizi,614
77309609565,2,92,Kraken210223142017-ara1,1442,1595,Kraken210223142017,0845Maqrizi.IghathaUmma,0845Maqrizi,153
77309609563,2,93,Kraken210223142017-ara1,409,729,Kraken210223142017,0845Maqrizi.IghathaUmma,0845Maqrizi,320
335007550411,2,36,Kraken210223142017-ara1,792,946,Kraken210223142017,0845Maqrizi.IghathaUmma,0845Maqrizi,154
506806184610,2,133,Kraken210223142017-ara1,540,879,Kraken210223142017,0845Maqrizi.IghathaUmma,0845Maqrizi,339
42949842141,2,68,Kraken210223142017-ara1,509,635,Kraken210223142017,0845Maqrizi.IghathaUmma,0845Maqrizi,126
